Date,Control Point,Arrival / Departure,Hong Kong Residents,Mainland Visitors,Other Visitors,Total
1/1/2023,China Ferry Terminal,Arrival,0,0,0,0
1/1/2023,China Ferry Terminal,Departure,0,0,0,0
2/1/2023,China Ferry Terminal,Arrival,0,0,0,0
2/1/2023,China Ferry Terminal,Departure,0,0,0,0
3/1/2023,China Ferry Terminal,Arrival,0,0,0,0
3/1/2023,China Ferry Terminal,Departure,0,0,0,0
4/1/2023,China Ferry Terminal,Arrival,0,0,0,0
4/1/2023,China Ferry Terminal,Departure,0,0,0,0
5/1/2023,China Ferry Terminal,Arrival,0,0,0,0
5/1/2023,China Ferry Terminal,Departure,0,0,0,0
6/1/2023,China Ferry Terminal,Arrival,0,0,0,0
6/1/2023,China Ferry Terminal,Departure,0,0,0,0
7/1/2023,China Ferry Terminal,Arrival,0,0,0,0
7/1/2023,China Ferry Terminal,Departure,0,0,0,0
8/1/2023,China Ferry Terminal,Arrival,29,12,1,42
8/1/2023,China Ferry Terminal,Departure,38,12,4,54
9/1/2023,China Ferry Terminal,Arrival,3,8,2,13
9/1/2023,China Ferry Terminal,Departure,23,15,1,39
10/1/2023,China Ferry Terminal,Arrival,6,5,4,15
10/1/2023,China Ferry Terminal,Departure,21,8,4,33
11/1/2023,China Ferry Terminal,Arrival,4,5,6,15
11/1/2023,China Ferry Terminal,Departure,35,13,3,51
12/1/2023,China Ferry Terminal,Arrival,26,51,4,81
12/1/2023,China Ferry Terminal,Departure,64,23,4,91
13-01-2023,China Ferry Terminal,Arrival,215,74,28,317
13-01-2023,China Ferry Terminal,Departure,174,63,8,245
14-01-2023,China Ferry Terminal,Arrival,204,100,23,327
14-01-2023,China Ferry Terminal,Departure,269,51,10,330
15-01-2023,China Ferry Terminal,Arrival,292,78,16,386
15-01-2023,China Ferry Terminal,Departure,272,75,12,359
16-01-2023,China Ferry Terminal,Arrival,232,91,28,351
16-01-2023,China Ferry Terminal,Departure,305,90,11,406
17-01-2023,China Ferry Terminal,Arrival,218,111,20,349
17-01-2023,China Ferry Terminal,Departure,390,89,17,496
18-01-2023,China Ferry Terminal,Arrival,239,113,15,367
18-01-2023,China Ferry Terminal,Departure,612,124,16,752
19-01-2023,China Ferry Terminal,Arrival,225,133,23,381
19-01-2023,China Ferry Terminal,Departure,1021,160,19,1200
20-01-2023,China Ferry Terminal,Arrival,188,204,23,415
20-01-2023,China Ferry Terminal,Departure,1430,158,33,1621
21-01-2023,China Ferry Terminal,Arrival,93,124,29,246
21-01-2023,China Ferry Terminal,Departure,1688,136,14,1838
22-01-2023,China Ferry Terminal,Arrival,114,190,10,314
22-01-2023,China Ferry Terminal,Departure,758,37,10,805
23-01-2023,China Ferry Terminal,Arrival,184,290,19,493
23-01-2023,China Ferry Terminal,Departure,679,82,13,774
24-01-2023,China Ferry Terminal,Arrival,500,285,13,798
24-01-2023,China Ferry Terminal,Departure,469,162,22,653
25-01-2023,China Ferry Terminal,Arrival,1132,449,30,1611
25-01-2023,China Ferry Terminal,Departure,370,242,28,640
26-01-2023,China Ferry Terminal,Arrival,784,314,14,1112
26-01-2023,China Ferry Terminal,Departure,406,327,27,760
27-01-2023,China Ferry Terminal,Arrival,709,227,28,964
27-01-2023,China Ferry Terminal,Departure,402,480,44,926
28-01-2023,China Ferry Terminal,Arrival,1005,212,17,1234
28-01-2023,China Ferry Terminal,Departure,416,473,38,927
29-01-2023,China Ferry Terminal,Arrival,1723,323,30,2076
29-01-2023,China Ferry Terminal,Departure,339,232,18,589
30-01-2023,China Ferry Terminal,Arrival,882,316,22,1220
30-01-2023,China Ferry Terminal,Departure,367,278,22,667
31-01-2023,China Ferry Terminal,Arrival,750,274,17,1041
31-01-2023,China Ferry Terminal,Departure,395,336,13,744
1/2/2023,China Ferry Terminal,Arrival,389,255,13,657
1/2/2023,China Ferry Terminal,Departure,364,197,11,572
2/2/2023,China Ferry Terminal,Arrival,340,186,19,545
2/2/2023,China Ferry Terminal,Departure,355,210,26,591
3/2/2023,China Ferry Terminal,Arrival,341,231,25,597
3/2/2023,China Ferry Terminal,Departure,470,281,22,773
4/2/2023,China Ferry Terminal,Arrival,283,202,10,495
4/2/2023,China Ferry Terminal,Departure,395,250,11,656
5/2/2023,China Ferry Terminal,Arrival,411,107,19,537
5/2/2023,China Ferry Terminal,Departure,209,210,32,451
6/2/2023,China Ferry Terminal,Arrival,537,252,16,805
6/2/2023,China Ferry Terminal,Departure,631,187,24,842
7/2/2023,China Ferry Terminal,Arrival,390,258,26,674
7/2/2023,China Ferry Terminal,Departure,510,191,22,723
8/2/2023,China Ferry Terminal,Arrival,419,278,23,720
8/2/2023,China Ferry Terminal,Departure,497,254,18,769
9/2/2023,China Ferry Terminal,Arrival,491,335,23,849
9/2/2023,China Ferry Terminal,Departure,610,253,32,895
10/2/2023,China Ferry Terminal,Arrival,556,404,26,986
10/2/2023,China Ferry Terminal,Departure,862,329,23,1214
11/2/2023,China Ferry Terminal,Arrival,473,356,35,864
11/2/2023,China Ferry Terminal,Departure,761,274,21,1056
12/2/2023,China Ferry Terminal,Arrival,949,316,22,1287
12/2/2023,China Ferry Terminal,Departure,481,390,41,912
13-02-2023,China Ferry Terminal,Arrival,597,389,19,1005
13-02-2023,China Ferry Terminal,Departure,646,284,26,956
14-02-2023,China Ferry Terminal,Arrival,481,308,15,804
14-02-2023,China Ferry Terminal,Departure,465,348,29,842
15-02-2023,China Ferry Terminal,Arrival,480,436,39,955
15-02-2023,China Ferry Terminal,Departure,562,323,40,925
16-02-2023,China Ferry Terminal,Arrival,521,455,23,999
16-02-2023,China Ferry Terminal,Departure,639,335,12,986
17-02-2023,China Ferry Terminal,Arrival,734,557,25,1316
17-02-2023,China Ferry Terminal,Departure,778,390,16,1184
18-02-2023,China Ferry Terminal,Arrival,485,704,47,1236
18-02-2023,China Ferry Terminal,Departure,896,400,26,1322
19-02-2023,China Ferry Terminal,Arrival,1048,493,27,1568
19-02-2023,China Ferry Terminal,Departure,505,544,39,1088
20-02-2023,China Ferry Terminal,Arrival,731,567,38,1336
20-02-2023,China Ferry Terminal,Departure,714,366,20,1100
21-02-2023,China Ferry Terminal,Arrival,543,599,29,1171
21-02-2023,China Ferry Terminal,Departure,613,354,21,988
22-02-2023,China Ferry Terminal,Arrival,558,529,30,1117
22-02-2023,China Ferry Terminal,Departure,545,388,23,956
23-02-2023,China Ferry Terminal,Arrival,526,455,35,1016
23-02-2023,China Ferry Terminal,Departure,591,418,27,1036
24-02-2023,China Ferry Terminal,Arrival,750,547,37,1334
24-02-2023,China Ferry Terminal,Departure,957,442,25,1424
25-02-2023,China Ferry Terminal,Arrival,582,670,35,1287
25-02-2023,China Ferry Terminal,Departure,899,338,26,1263
26-02-2023,China Ferry Terminal,Arrival,1139,420,36,1595
26-02-2023,China Ferry Terminal,Departure,502,531,40,1073
27-02-2023,China Ferry Terminal,Arrival,672,414,28,1114
27-02-2023,China Ferry Terminal,Departure,713,373,45,1131
28-02-2023,China Ferry Terminal,Arrival,592,453,28,1073
28-02-2023,China Ferry Terminal,Departure,623,341,34,998
1/3/2023,China Ferry Terminal,Arrival,546,402,38,986
1/3/2023,China Ferry Terminal,Departure,603,341,31,975
2/3/2023,China Ferry Terminal,Arrival,573,417,26,1016
2/3/2023,China Ferry Terminal,Departure,621,307,18,946
3/3/2023,China Ferry Terminal,Arrival,751,544,53,1348
3/3/2023,China Ferry Terminal,Departure,1041,421,35,1497
4/3/2023,China Ferry Terminal,Arrival,552,693,69,1314
4/3/2023,China Ferry Terminal,Departure,962,326,34,1322
5/3/2023,China Ferry Terminal,Arrival,1191,545,19,1755
5/3/2023,China Ferry Terminal,Departure,505,562,57,1124
6/3/2023,China Ferry Terminal,Arrival,627,484,26,1137
6/3/2023,China Ferry Terminal,Departure,679,379,33,1091
7/3/2023,China Ferry Terminal,Arrival,482,421,44,947
7/3/2023,China Ferry Terminal,Departure,583,382,34,999
8/3/2023,China Ferry Terminal,Arrival,509,401,37,947
8/3/2023,China Ferry Terminal,Departure,550,384,37,971
9/3/2023,China Ferry Terminal,Arrival,574,486,53,1113
9/3/2023,China Ferry Terminal,Departure,647,405,36,1088
10/3/2023,China Ferry Terminal,Arrival,707,572,63,1342
10/3/2023,China Ferry Terminal,Departure,974,394,29,1397
11/3/2023,China Ferry Terminal,Arrival,473,803,49,1325
11/3/2023,China Ferry Terminal,Departure,845,398,41,1284
12/3/2023,China Ferry Terminal,Arrival,1238,469,21,1728
12/3/2023,China Ferry Terminal,Departure,507,723,38,1268
13-03-2023,China Ferry Terminal,Arrival,698,507,28,1233
13-03-2023,China Ferry Terminal,Departure,683,351,35,1069
14-03-2023,China Ferry Terminal,Arrival,570,430,52,1052
14-03-2023,China Ferry Terminal,Departure,549,400,31,980
15-03-2023,China Ferry Terminal,Arrival,527,495,45,1067
15-03-2023,China Ferry Terminal,Departure,628,368,35,1031
16-03-2023,China Ferry Terminal,Arrival,536,456,53,1045
16-03-2023,China Ferry Terminal,Departure,650,390,38,1078
17-03-2023,China Ferry Terminal,Arrival,695,631,47,1373
17-03-2023,China Ferry Terminal,Departure,943,505,32,1480
18-03-2023,China Ferry Terminal,Arrival,599,868,76,1543
18-03-2023,China Ferry Terminal,Departure,870,409,35,1314
19-03-2023,China Ferry Terminal,Arrival,1178,635,47,1860
19-03-2023,China Ferry Terminal,Departure,457,700,74,1231
20-03-2023,China Ferry Terminal,Arrival,694,473,30,1197
20-03-2023,China Ferry Terminal,Departure,710,490,39,1239
21-03-2023,China Ferry Terminal,Arrival,519,494,49,1062
21-03-2023,China Ferry Terminal,Departure,548,353,22,923
22-03-2023,China Ferry Terminal,Arrival,436,481,36,953
22-03-2023,China Ferry Terminal,Departure,476,353,38,867
23-03-2023,China Ferry Terminal,Arrival,534,555,30,1119
23-03-2023,China Ferry Terminal,Departure,515,400,27,942
24-03-2023,China Ferry Terminal,Arrival,597,811,67,1475
24-03-2023,China Ferry Terminal,Departure,851,439,23,1313
25-03-2023,China Ferry Terminal,Arrival,509,853,67,1429
25-03-2023,China Ferry Terminal,Departure,646,519,29,1194
26-03-2023,China Ferry Terminal,Arrival,1099,422,41,1562
26-03-2023,China Ferry Terminal,Departure,426,733,44,1203
27-03-2023,China Ferry Terminal,Arrival,531,364,34,929
27-03-2023,China Ferry Terminal,Departure,635,376,45,1056
28-03-2023,China Ferry Terminal,Arrival,454,325,35,814
28-03-2023,China Ferry Terminal,Departure,497,345,34,876
29-03-2023,China Ferry Terminal,Arrival,493,397,50,940
29-03-2023,China Ferry Terminal,Departure,605,323,42,970
30-03-2023,China Ferry Terminal,Arrival,531,591,32,1154
30-03-2023,China Ferry Terminal,Departure,616,491,32,1139
31-03-2023,China Ferry Terminal,Arrival,731,659,57,1447
31-03-2023,China Ferry Terminal,Departure,896,546,29,1471
1/4/2023,China Ferry Terminal,Arrival,456,962,78,1496
1/4/2023,China Ferry Terminal,Departure,1518,529,32,2079
2/4/2023,China Ferry Terminal,Arrival,727,467,47,1241
2/4/2023,China Ferry Terminal,Departure,901,766,57,1724
3/4/2023,China Ferry Terminal,Arrival,499,353,58,910
3/4/2023,China Ferry Terminal,Departure,1118,453,59,1630
4/4/2023,China Ferry Terminal,Arrival,540,360,34,934
4/4/2023,China Ferry Terminal,Departure,2932,441,54,3427
5/4/2023,China Ferry Terminal,Arrival,888,492,53,1433
5/4/2023,China Ferry Terminal,Departure,2777,435,59,3271
6/4/2023,China Ferry Terminal,Arrival,1151,411,50,1612
6/4/2023,China Ferry Terminal,Departure,2776,394,53,3223
7/4/2023,China Ferry Terminal,Arrival,1097,432,43,1572
7/4/2023,China Ferry Terminal,Departure,4044,310,40,4394
8/4/2023,China Ferry Terminal,Arrival,1774,692,49,2515
8/4/2023,China Ferry Terminal,Departure,2295,403,43,2741
9/4/2023,China Ferry Terminal,Arrival,3635,334,34,4003
9/4/2023,China Ferry Terminal,Departure,1005,477,52,1534
10/4/2023,China Ferry Terminal,Arrival,4302,597,41,4940
10/4/2023,China Ferry Terminal,Departure,629,306,26,961
11/4/2023,China Ferry Terminal,Arrival,1715,1291,77,3083
11/4/2023,China Ferry Terminal,Departure,643,345,30,1018
12/4/2023,China Ferry Terminal,Arrival,1058,964,93,2115
12/4/2023,China Ferry Terminal,Departure,605,604,67,1276
13-04-2023,China Ferry Terminal,Arrival,835,980,81,1896
13-04-2023,China Ferry Terminal,Departure,662,804,76,1542
14-04-2023,China Ferry Terminal,Arrival,906,1092,80,2078
14-04-2023,China Ferry Terminal,Departure,1106,1011,131,2248
15-04-2023,China Ferry Terminal,Arrival,904,1196,62,2162
15-04-2023,China Ferry Terminal,Departure,1439,1079,113,2631
16-04-2023,China Ferry Terminal,Arrival,1871,866,48,2785
16-04-2023,China Ferry Terminal,Departure,682,890,103,1675
17-04-2023,China Ferry Terminal,Arrival,880,635,61,1576
17-04-2023,China Ferry Terminal,Departure,731,539,69,1339
18-04-2023,China Ferry Terminal,Arrival,679,726,103,1508
18-04-2023,China Ferry Terminal,Departure,651,526,65,1242
19-04-2023,China Ferry Terminal,Arrival,581,450,117,1148
19-04-2023,China Ferry Terminal,Departure,573,418,77,1068
20-04-2023,China Ferry Terminal,Arrival,593,496,100,1189
20-04-2023,China Ferry Terminal,Departure,536,457,34,1027
21-04-2023,China Ferry Terminal,Arrival,753,632,108,1493
21-04-2023,China Ferry Terminal,Departure,979,473,51,1503
22-04-2023,China Ferry Terminal,Arrival,695,775,93,1563
22-04-2023,China Ferry Terminal,Departure,1130,564,67,1761
23-04-2023,China Ferry Terminal,Arrival,1301,728,52,2081
23-04-2023,China Ferry Terminal,Departure,565,640,52,1257
24-04-2023,China Ferry Terminal,Arrival,750,555,73,1378
24-04-2023,China Ferry Terminal,Departure,780,421,65,1266
25-04-2023,China Ferry Terminal,Arrival,610,573,93,1276
25-04-2023,China Ferry Terminal,Departure,666,566,39,1271
26-04-2023,China Ferry Terminal,Arrival,685,637,91,1413
26-04-2023,China Ferry Terminal,Departure,559,469,34,1062
27-04-2023,China Ferry Terminal,Arrival,612,694,87,1393
27-04-2023,China Ferry Terminal,Departure,627,518,45,1190
28-04-2023,China Ferry Terminal,Arrival,816,1039,129,1984
28-04-2023,China Ferry Terminal,Departure,1334,515,55,1904
29-04-2023,China Ferry Terminal,Arrival,866,2557,142,3565
29-04-2023,China Ferry Terminal,Departure,2452,852,68,3372
30-04-2023,China Ferry Terminal,Arrival,1127,2001,98,3226
30-04-2023,China Ferry Terminal,Departure,1015,1076,93,2184
1/5/2023,China Ferry Terminal,Arrival,2692,1966,80,4738
1/5/2023,China Ferry Terminal,Departure,464,1573,65,2102
2/5/2023,China Ferry Terminal,Arrival,976,1637,82,2695
2/5/2023,China Ferry Terminal,Departure,650,2149,66,2865
3/5/2023,China Ferry Terminal,Arrival,553,585,60,1198
3/5/2023,China Ferry Terminal,Departure,792,2112,89,2993
4/5/2023,China Ferry Terminal,Arrival,503,513,40,1056
4/5/2023,China Ferry Terminal,Departure,557,506,36,1099
5/5/2023,China Ferry Terminal,Arrival,617,647,63,1327
5/5/2023,China Ferry Terminal,Departure,737,407,38,1182
6/5/2023,China Ferry Terminal,Arrival,525,776,69,1370
6/5/2023,China Ferry Terminal,Departure,742,494,49,1285
7/5/2023,China Ferry Terminal,Arrival,975,670,37,1682
7/5/2023,China Ferry Terminal,Departure,382,625,69,1076
8/5/2023,China Ferry Terminal,Arrival,534,470,45,1049
8/5/2023,China Ferry Terminal,Departure,757,508,61,1326
9/5/2023,China Ferry Terminal,Arrival,468,579,74,1121
9/5/2023,China Ferry Terminal,Departure,637,451,44,1132
10/5/2023,China Ferry Terminal,Arrival,553,811,65,1429
10/5/2023,China Ferry Terminal,Departure,557,422,54,1033
11/5/2023,China Ferry Terminal,Arrival,564,782,70,1416
11/5/2023,China Ferry Terminal,Departure,573,623,50,1246
12/5/2023,China Ferry Terminal,Arrival,715,662,89,1466
12/5/2023,China Ferry Terminal,Departure,973,620,42,1635
13-05-2023,China Ferry Terminal,Arrival,661,1484,71,2216
13-05-2023,China Ferry Terminal,Departure,759,485,33,1277
14-05-2023,China Ferry Terminal,Arrival,1113,795,61,1969
14-05-2023,China Ferry Terminal,Departure,526,1008,79,1613
15-05-2023,China Ferry Terminal,Arrival,584,826,59,1469
15-05-2023,China Ferry Terminal,Departure,781,703,53,1537
16-05-2023,China Ferry Terminal,Arrival,549,719,61,1329
16-05-2023,China Ferry Terminal,Departure,594,704,42,1340
17-05-2023,China Ferry Terminal,Arrival,503,587,46,1136
17-05-2023,China Ferry Terminal,Departure,599,605,64,1268
18-05-2023,China Ferry Terminal,Arrival,697,739,69,1505
18-05-2023,China Ferry Terminal,Departure,605,519,35,1159
19-05-2023,China Ferry Terminal,Arrival,700,820,81,1601
19-05-2023,China Ferry Terminal,Departure,868,700,47,1615
20-05-2023,China Ferry Terminal,Arrival,541,1046,75,1662
20-05-2023,China Ferry Terminal,Departure,769,746,36,1551
21-05-2023,China Ferry Terminal,Arrival,1000,565,59,1624
21-05-2023,China Ferry Terminal,Departure,462,977,83,1522
22-05-2023,China Ferry Terminal,Arrival,568,522,40,1130
22-05-2023,China Ferry Terminal,Departure,693,495,56,1244
23-05-2023,China Ferry Terminal,Arrival,445,535,63,1043
23-05-2023,China Ferry Terminal,Departure,666,413,63,1142
24-05-2023,China Ferry Terminal,Arrival,564,519,75,1158
24-05-2023,China Ferry Terminal,Departure,688,481,63,1232
25-05-2023,China Ferry Terminal,Arrival,657,547,56,1260
25-05-2023,China Ferry Terminal,Departure,1650,489,46,2185
26-05-2023,China Ferry Terminal,Arrival,689,445,70,1204
26-05-2023,China Ferry Terminal,Departure,2543,406,27,2976
27-05-2023,China Ferry Terminal,Arrival,968,944,82,1994
27-05-2023,China Ferry Terminal,Departure,651,473,21,1145
28-05-2023,China Ferry Terminal,Arrival,2738,479,44,3261
28-05-2023,China Ferry Terminal,Departure,442,736,58,1236
29-05-2023,China Ferry Terminal,Arrival,855,527,41,1423
29-05-2023,China Ferry Terminal,Departure,598,474,46,1118
30-05-2023,China Ferry Terminal,Arrival,574,418,56,1048
30-05-2023,China Ferry Terminal,Departure,615,377,43,1035
31-05-2023,China Ferry Terminal,Arrival,520,550,46,1116
31-05-2023,China Ferry Terminal,Departure,475,415,47,937
1/6/2023,China Ferry Terminal,Arrival,510,451,51,1012
1/6/2023,China Ferry Terminal,Departure,504,432,30,966
2/6/2023,China Ferry Terminal,Arrival,671,541,45,1257
2/6/2023,China Ferry Terminal,Departure,687,402,35,1124
3/6/2023,China Ferry Terminal,Arrival,478,707,40,1225
3/6/2023,China Ferry Terminal,Departure,687,443,54,1184
4/6/2023,China Ferry Terminal,Arrival,841,406,31,1278
4/6/2023,China Ferry Terminal,Departure,406,644,49,1099
5/6/2023,China Ferry Terminal,Arrival,509,502,47,1058
5/6/2023,China Ferry Terminal,Departure,626,332,54,1012
6/6/2023,China Ferry Terminal,Arrival,522,642,52,1216
6/6/2023,China Ferry Terminal,Departure,585,440,68,1093
7/6/2023,China Ferry Terminal,Arrival,518,613,37,1168
7/6/2023,China Ferry Terminal,Departure,590,465,58,1113
8/6/2023,China Ferry Terminal,Arrival,571,508,48,1127
8/6/2023,China Ferry Terminal,Departure,612,596,54,1262
9/6/2023,China Ferry Terminal,Arrival,702,620,83,1405
9/6/2023,China Ferry Terminal,Departure,929,503,45,1477
10/6/2023,China Ferry Terminal,Arrival,490,1067,62,1619
10/6/2023,China Ferry Terminal,Departure,805,436,46,1287
11/6/2023,China Ferry Terminal,Arrival,1106,569,35,1710
11/6/2023,China Ferry Terminal,Departure,486,882,64,1432
12/6/2023,China Ferry Terminal,Arrival,607,560,62,1229
12/6/2023,China Ferry Terminal,Departure,693,518,56,1267
13-06-2023,China Ferry Terminal,Arrival,478,506,63,1047
13-06-2023,China Ferry Terminal,Departure,556,382,49,987
14-06-2023,China Ferry Terminal,Arrival,581,562,73,1216
14-06-2023,China Ferry Terminal,Departure,543,489,51,1083
15-06-2023,China Ferry Terminal,Arrival,587,548,91,1226
15-06-2023,China Ferry Terminal,Departure,606,398,41,1045
16-06-2023,China Ferry Terminal,Arrival,677,619,82,1378
16-06-2023,China Ferry Terminal,Departure,911,494,49,1454
17-06-2023,China Ferry Terminal,Arrival,522,661,56,1239
17-06-2023,China Ferry Terminal,Departure,757,370,42,1169
18-06-2023,China Ferry Terminal,Arrival,1016,471,37,1524
18-06-2023,China Ferry Terminal,Departure,532,713,54,1299
19-06-2023,China Ferry Terminal,Arrival,601,530,59,1190
19-06-2023,China Ferry Terminal,Departure,758,510,41,1309
20-06-2023,China Ferry Terminal,Arrival,589,546,42,1177
20-06-2023,China Ferry Terminal,Departure,703,463,55,1221
21-06-2023,China Ferry Terminal,Arrival,799,675,59,1533
21-06-2023,China Ferry Terminal,Departure,1032,507,52,1591
22-06-2023,China Ferry Terminal,Arrival,625,1493,103,2221
22-06-2023,China Ferry Terminal,Departure,1101,533,60,1694
23-06-2023,China Ferry Terminal,Arrival,576,1050,68,1694
23-06-2023,China Ferry Terminal,Departure,822,824,53,1699
24-06-2023,China Ferry Terminal,Arrival,751,491,53,1295
24-06-2023,China Ferry Terminal,Departure,1006,1009,57,2072
25-06-2023,China Ferry Terminal,Arrival,1753,515,40,2308
25-06-2023,China Ferry Terminal,Departure,489,561,48,1098
26-06-2023,China Ferry Terminal,Arrival,852,676,83,1611
26-06-2023,China Ferry Terminal,Departure,794,537,71,1402
27-06-2023,China Ferry Terminal,Arrival,686,536,47,1269
27-06-2023,China Ferry Terminal,Departure,616,463,47,1126
28-06-2023,China Ferry Terminal,Arrival,488,581,54,1123
28-06-2023,China Ferry Terminal,Departure,589,475,52,1116
29-06-2023,China Ferry Terminal,Arrival,605,620,49,1274
29-06-2023,China Ferry Terminal,Departure,575,633,39,1247
30-06-2023,China Ferry Terminal,Arrival,897,704,68,1669
30-06-2023,China Ferry Terminal,Departure,1377,548,41,1966
1/7/2023,China Ferry Terminal,Arrival,549,894,56,1499
1/7/2023,China Ferry Terminal,Departure,1493,484,41,2018
2/7/2023,China Ferry Terminal,Arrival,2062,705,44,2811
2/7/2023,China Ferry Terminal,Departure,375,669,37,1081
3/7/2023,China Ferry Terminal,Arrival,702,691,52,1445
3/7/2023,China Ferry Terminal,Departure,731,525,52,1308
4/7/2023,China Ferry Terminal,Arrival,749,628,50,1427
4/7/2023,China Ferry Terminal,Departure,725,539,47,1311
5/7/2023,China Ferry Terminal,Arrival,556,654,70,1280
5/7/2023,China Ferry Terminal,Departure,571,619,73,1263
6/7/2023,China Ferry Terminal,Arrival,660,595,67,1322
6/7/2023,China Ferry Terminal,Departure,604,620,54,1278
7/7/2023,China Ferry Terminal,Arrival,869,581,74,1524
7/7/2023,China Ferry Terminal,Departure,861,536,61,1458
8/7/2023,China Ferry Terminal,Arrival,509,1257,60,1826
8/7/2023,China Ferry Terminal,Departure,945,804,40,1789
9/7/2023,China Ferry Terminal,Arrival,1200,958,40,2198
9/7/2023,China Ferry Terminal,Departure,565,897,55,1517
10/7/2023,China Ferry Terminal,Arrival,745,934,81,1760
10/7/2023,China Ferry Terminal,Departure,736,630,77,1443
11/7/2023,China Ferry Terminal,Arrival,633,890,73,1596
11/7/2023,China Ferry Terminal,Departure,627,714,56,1397
12/7/2023,China Ferry Terminal,Arrival,584,711,64,1359
12/7/2023,China Ferry Terminal,Departure,642,731,64,1437
13-07-2023,China Ferry Terminal,Arrival,607,833,52,1492
13-07-2023,China Ferry Terminal,Departure,846,729,54,1629
14-07-2023,China Ferry Terminal,Arrival,807,865,89,1761
14-07-2023,China Ferry Terminal,Departure,1235,832,46,2113
15-07-2023,China Ferry Terminal,Arrival,709,1225,76,2010
15-07-2023,China Ferry Terminal,Departure,1198,774,44,2016
16-07-2023,China Ferry Terminal,Arrival,844,563,45,1452
16-07-2023,China Ferry Terminal,Departure,433,806,34,1273
17-07-2023,China Ferry Terminal,Arrival,0,0,0,0
17-07-2023,China Ferry Terminal,Departure,0,0,0,0
18-07-2023,China Ferry Terminal,Arrival,595,371,23,989
18-07-2023,China Ferry Terminal,Departure,679,407,54,1140
19-07-2023,China Ferry Terminal,Arrival,594,773,43,1410
19-07-2023,China Ferry Terminal,Departure,762,566,31,1359
20-07-2023,China Ferry Terminal,Arrival,640,851,64,1555
20-07-2023,China Ferry Terminal,Departure,778,695,62,1535
21-07-2023,China Ferry Terminal,Arrival,701,953,77,1731
21-07-2023,China Ferry Terminal,Departure,1134,781,60,1975
22-07-2023,China Ferry Terminal,Arrival,543,1659,78,2280
22-07-2023,China Ferry Terminal,Departure,1178,1045,51,2274
23-07-2023,China Ferry Terminal,Arrival,1217,1183,69,2469
23-07-2023,China Ferry Terminal,Departure,527,1228,61,1816
24-07-2023,China Ferry Terminal,Arrival,768,1016,46,1830
24-07-2023,China Ferry Terminal,Departure,766,854,52,1672
25-07-2023,China Ferry Terminal,Arrival,668,975,53,1696
25-07-2023,China Ferry Terminal,Departure,728,774,47,1549
26-07-2023,China Ferry Terminal,Arrival,658,933,54,1645
26-07-2023,China Ferry Terminal,Departure,640,892,82,1614
27-07-2023,China Ferry Terminal,Arrival,540,782,57,1379
27-07-2023,China Ferry Terminal,Departure,567,700,48,1315
28-07-2023,China Ferry Terminal,Arrival,568,747,79,1394
28-07-2023,China Ferry Terminal,Departure,927,802,30,1759
29-07-2023,China Ferry Terminal,Arrival,490,1244,48,1782
29-07-2023,China Ferry Terminal,Departure,1099,805,22,1926
30-07-2023,China Ferry Terminal,Arrival,1270,1022,66,2358
30-07-2023,China Ferry Terminal,Departure,535,1112,66,1713
31-07-2023,China Ferry Terminal,Arrival,795,943,64,1802
31-07-2023,China Ferry Terminal,Departure,762,832,62,1656
1/8/2023,China Ferry Terminal,Arrival,736,1017,48,1801
1/8/2023,China Ferry Terminal,Departure,718,844,40,1602
2/8/2023,China Ferry Terminal,Arrival,598,930,43,1571
2/8/2023,China Ferry Terminal,Departure,766,840,40,1646
3/8/2023,China Ferry Terminal,Arrival,733,1094,59,1886
3/8/2023,China Ferry Terminal,Departure,789,916,47,1752
4/8/2023,China Ferry Terminal,Arrival,799,1199,87,2085
4/8/2023,China Ferry Terminal,Departure,1255,993,47,2295
5/8/2023,China Ferry Terminal,Arrival,721,1885,56,2662
5/8/2023,China Ferry Terminal,Departure,1395,1093,59,2547
6/8/2023,China Ferry Terminal,Arrival,1654,1323,49,3026
6/8/2023,China Ferry Terminal,Departure,620,1429,69,2118
7/8/2023,China Ferry Terminal,Arrival,895,1144,53,2092
7/8/2023,China Ferry Terminal,Departure,842,1042,59,1943
8/8/2023,China Ferry Terminal,Arrival,796,1109,69,1974
8/8/2023,China Ferry Terminal,Departure,749,905,44,1698
9/8/2023,China Ferry Terminal,Arrival,702,1018,55,1775
9/8/2023,China Ferry Terminal,Departure,737,954,62,1753
10/8/2023,China Ferry Terminal,Arrival,687,1103,121,1911
10/8/2023,China Ferry Terminal,Departure,821,1065,61,1947
11/8/2023,China Ferry Terminal,Arrival,791,1158,95,2044
11/8/2023,China Ferry Terminal,Departure,1177,1185,65,2427
12/8/2023,China Ferry Terminal,Arrival,754,1972,86,2812
12/8/2023,China Ferry Terminal,Departure,1343,1287,69,2699
13-08-2023,China Ferry Terminal,Arrival,1803,1347,62,3212
13-08-2023,China Ferry Terminal,Departure,710,1511,53,2274
14-08-2023,China Ferry Terminal,Arrival,939,1239,62,2240
14-08-2023,China Ferry Terminal,Departure,824,1072,79,1975
15-08-2023,China Ferry Terminal,Arrival,798,1106,47,1951
15-08-2023,China Ferry Terminal,Departure,722,1017,46,1785
16-08-2023,China Ferry Terminal,Arrival,706,1208,71,1985
16-08-2023,China Ferry Terminal,Departure,709,1024,51,1784
17-08-2023,China Ferry Terminal,Arrival,693,1262,84,2039
17-08-2023,China Ferry Terminal,Departure,756,1099,51,1906
18-08-2023,China Ferry Terminal,Arrival,837,1274,86,2197
18-08-2023,China Ferry Terminal,Departure,1338,1227,81,2646
19-08-2023,China Ferry Terminal,Arrival,643,1711,53,2407
19-08-2023,China Ferry Terminal,Departure,1183,1212,57,2452
20-08-2023,China Ferry Terminal,Arrival,1727,1422,62,3211
20-08-2023,China Ferry Terminal,Departure,662,1601,75,2338
21-08-2023,China Ferry Terminal,Arrival,883,1209,70,2162
21-08-2023,China Ferry Terminal,Departure,848,1009,63,1920
22-08-2023,China Ferry Terminal,Arrival,719,1046,60,1825
22-08-2023,China Ferry Terminal,Departure,728,1035,69,1832
23-08-2023,China Ferry Terminal,Arrival,691,1107,78,1876
23-08-2023,China Ferry Terminal,Departure,662,1031,92,1785
24-08-2023,China Ferry Terminal,Arrival,728,1109,76,1913
24-08-2023,China Ferry Terminal,Departure,761,1011,69,1841
25-08-2023,China Ferry Terminal,Arrival,856,1342,85,2283
25-08-2023,China Ferry Terminal,Departure,1381,1161,56,2598
26-08-2023,China Ferry Terminal,Arrival,772,1725,63,2560
26-08-2023,China Ferry Terminal,Departure,1250,1326,56,2632
27-08-2023,China Ferry Terminal,Arrival,1664,1118,43,2825
27-08-2023,China Ferry Terminal,Departure,617,1433,71,2121
28-08-2023,China Ferry Terminal,Arrival,931,935,61,1927
28-08-2023,China Ferry Terminal,Departure,752,1002,68,1822
29-08-2023,China Ferry Terminal,Arrival,686,667,80,1433
29-08-2023,China Ferry Terminal,Departure,531,816,40,1387
30-08-2023,China Ferry Terminal,Arrival,719,513,57,1289
30-08-2023,China Ferry Terminal,Departure,558,709,64,1331
31-08-2023,China Ferry Terminal,Arrival,243,283,42,568
31-08-2023,China Ferry Terminal,Departure,372,243,28,643
1/9/2023,China Ferry Terminal,Arrival,0,0,0,0
1/9/2023,China Ferry Terminal,Departure,0,0,0,0
2/9/2023,China Ferry Terminal,Arrival,0,0,0,0
2/9/2023,China Ferry Terminal,Departure,0,0,0,0
3/9/2023,China Ferry Terminal,Arrival,536,222,18,776
3/9/2023,China Ferry Terminal,Departure,270,172,25,467
4/9/2023,China Ferry Terminal,Arrival,467,496,40,1003
4/9/2023,China Ferry Terminal,Departure,499,326,67,892
5/9/2023,China Ferry Terminal,Arrival,448,493,32,973
5/9/2023,China Ferry Terminal,Departure,582,373,54,1009
6/9/2023,China Ferry Terminal,Arrival,486,487,67,1040
6/9/2023,China Ferry Terminal,Departure,570,397,37,1004
7/9/2023,China Ferry Terminal,Arrival,474,518,61,1053
7/9/2023,China Ferry Terminal,Departure,514,470,49,1033
8/9/2023,China Ferry Terminal,Arrival,638,394,44,1076
8/9/2023,China Ferry Terminal,Departure,808,376,55,1239
9/9/2023,China Ferry Terminal,Arrival,530,496,58,1084
9/9/2023,China Ferry Terminal,Departure,1036,365,47,1448
10/9/2023,China Ferry Terminal,Arrival,1189,336,52,1577
10/9/2023,China Ferry Terminal,Departure,389,557,61,1007
11/9/2023,China Ferry Terminal,Arrival,543,442,33,1018
11/9/2023,China Ferry Terminal,Departure,649,306,55,1010
12/9/2023,China Ferry Terminal,Arrival,439,417,43,899
12/9/2023,China Ferry Terminal,Departure,522,350,50,922
13-09-2023,China Ferry Terminal,Arrival,520,533,51,1104
13-09-2023,China Ferry Terminal,Departure,531,462,53,1046
14-09-2023,China Ferry Terminal,Arrival,495,454,52,1001
14-09-2023,China Ferry Terminal,Departure,508,424,37,969
15-09-2023,China Ferry Terminal,Arrival,663,559,73,1295
15-09-2023,China Ferry Terminal,Departure,1006,529,51,1586
16-09-2023,China Ferry Terminal,Arrival,548,791,67,1406
16-09-2023,China Ferry Terminal,Departure,1164,480,65,1709
17-09-2023,China Ferry Terminal,Arrival,1432,640,58,2130
17-09-2023,China Ferry Terminal,Departure,504,789,94,1387
18-09-2023,China Ferry Terminal,Arrival,639,454,47,1140
18-09-2023,China Ferry Terminal,Departure,708,363,76,1147
19-09-2023,China Ferry Terminal,Arrival,524,552,77,1153
19-09-2023,China Ferry Terminal,Departure,670,451,69,1190
20-09-2023,China Ferry Terminal,Arrival,582,500,64,1146
20-09-2023,China Ferry Terminal,Departure,619,444,62,1125
21-09-2023,China Ferry Terminal,Arrival,701,599,90,1390
21-09-2023,China Ferry Terminal,Departure,631,509,80,1220
22-09-2023,China Ferry Terminal,Arrival,752,710,99,1561
22-09-2023,China Ferry Terminal,Departure,836,549,66,1451
23-09-2023,China Ferry Terminal,Arrival,637,928,80,1645
23-09-2023,China Ferry Terminal,Departure,1293,605,54,1952
24-09-2023,China Ferry Terminal,Arrival,1371,581,63,2015
24-09-2023,China Ferry Terminal,Departure,501,851,79,1431
25-09-2023,China Ferry Terminal,Arrival,646,571,80,1297
25-09-2023,China Ferry Terminal,Departure,830,387,64,1281
26-09-2023,China Ferry Terminal,Arrival,530,524,61,1115
26-09-2023,China Ferry Terminal,Departure,735,594,54,1383
27-09-2023,China Ferry Terminal,Arrival,682,481,62,1225
27-09-2023,China Ferry Terminal,Departure,822,501,36,1359
28-09-2023,China Ferry Terminal,Arrival,923,555,85,1563
28-09-2023,China Ferry Terminal,Departure,1369,484,56,1909
29-09-2023,China Ferry Terminal,Arrival,646,1552,74,2272
29-09-2023,China Ferry Terminal,Departure,3924,515,54,4493
30-09-2023,China Ferry Terminal,Arrival,741,2329,87,3157
30-09-2023,China Ferry Terminal,Departure,4050,859,34,4943
1/10/2023,China Ferry Terminal,Arrival,1787,2403,59,4249
1/10/2023,China Ferry Terminal,Departure,919,1155,43,2117
2/10/2023,China Ferry Terminal,Arrival,4528,1854,76,6458
2/10/2023,China Ferry Terminal,Departure,544,1822,47,2413
3/10/2023,China Ferry Terminal,Arrival,1701,2340,120,4161
3/10/2023,China Ferry Terminal,Departure,668,1873,65,2606
4/10/2023,China Ferry Terminal,Arrival,755,1649,66,2470
4/10/2023,China Ferry Terminal,Departure,746,1877,74,2697
5/10/2023,China Ferry Terminal,Arrival,819,928,81,1828
5/10/2023,China Ferry Terminal,Departure,734,2015,97,2846
6/10/2023,China Ferry Terminal,Arrival,472,441,40,953
6/10/2023,China Ferry Terminal,Departure,756,993,67,1816
7/10/2023,China Ferry Terminal,Arrival,0,0,0,0
7/10/2023,China Ferry Terminal,Departure,0,0,0,0
8/10/2023,China Ferry Terminal,Arrival,0,0,0,0
8/10/2023,China Ferry Terminal,Departure,0,0,0,0
9/10/2023,China Ferry Terminal,Arrival,345,98,13,456
9/10/2023,China Ferry Terminal,Departure,145,67,20,232
10/10/2023,China Ferry Terminal,Arrival,559,441,66,1066
10/10/2023,China Ferry Terminal,Departure,618,279,73,970
11/10/2023,China Ferry Terminal,Arrival,520,475,60,1055
11/10/2023,China Ferry Terminal,Departure,670,349,73,1092
12/10/2023,China Ferry Terminal,Arrival,545,660,70,1275
12/10/2023,China Ferry Terminal,Departure,667,478,75,1220
13-10-2023,China Ferry Terminal,Arrival,774,701,80,1555
13-10-2023,China Ferry Terminal,Departure,1001,575,79,1655
14-10-2023,China Ferry Terminal,Arrival,582,894,82,1558
14-10-2023,China Ferry Terminal,Departure,1063,654,172,1889
15-10-2023,China Ferry Terminal,Arrival,1270,534,87,1891
15-10-2023,China Ferry Terminal,Departure,533,847,160,1540
16-10-2023,China Ferry Terminal,Arrival,682,537,72,1291
16-10-2023,China Ferry Terminal,Departure,814,616,134,1564
17-10-2023,China Ferry Terminal,Arrival,558,461,71,1090
17-10-2023,China Ferry Terminal,Departure,628,429,76,1133
18-10-2023,China Ferry Terminal,Arrival,599,440,99,1138
18-10-2023,China Ferry Terminal,Departure,599,368,55,1022
19-10-2023,China Ferry Terminal,Arrival,490,492,153,1135
19-10-2023,China Ferry Terminal,Departure,627,387,93,1107
20-10-2023,China Ferry Terminal,Arrival,621,505,132,1258
20-10-2023,China Ferry Terminal,Departure,1358,447,64,1869
21-10-2023,China Ferry Terminal,Arrival,539,787,87,1413
21-10-2023,China Ferry Terminal,Departure,2729,534,68,3331
22-10-2023,China Ferry Terminal,Arrival,961,540,69,1570
22-10-2023,China Ferry Terminal,Departure,1316,752,152,2220
23-10-2023,China Ferry Terminal,Arrival,3243,468,50,3761
23-10-2023,China Ferry Terminal,Departure,535,377,138,1050
24-10-2023,China Ferry Terminal,Arrival,959,617,74,1650
24-10-2023,China Ferry Terminal,Departure,713,429,75,1217
25-10-2023,China Ferry Terminal,Arrival,602,1119,139,1860
25-10-2023,China Ferry Terminal,Departure,554,436,54,1044
26-10-2023,China Ferry Terminal,Arrival,612,1755,361,2728
26-10-2023,China Ferry Terminal,Departure,580,512,68,1160
27-10-2023,China Ferry Terminal,Arrival,759,1425,307,2491
27-10-2023,China Ferry Terminal,Departure,921,1292,71,2284
28-10-2023,China Ferry Terminal,Arrival,613,1550,174,2337
28-10-2023,China Ferry Terminal,Departure,1021,1477,112,2610
29-10-2023,China Ferry Terminal,Arrival,1413,859,97,2369
29-10-2023,China Ferry Terminal,Departure,567,1473,239,2279
30-10-2023,China Ferry Terminal,Arrival,843,679,61,1583
30-10-2023,China Ferry Terminal,Departure,696,1832,367,2895
31-10-2023,China Ferry Terminal,Arrival,518,467,82,1067
31-10-2023,China Ferry Terminal,Departure,538,523,149,1210
1/11/2023,China Ferry Terminal,Arrival,516,515,75,1106
1/11/2023,China Ferry Terminal,Departure,614,440,58,1112
2/11/2023,China Ferry Terminal,Arrival,552,472,85,1109
2/11/2023,China Ferry Terminal,Departure,603,495,47,1145
3/11/2023,China Ferry Terminal,Arrival,688,587,133,1408
3/11/2023,China Ferry Terminal,Departure,1087,477,46,1610
4/11/2023,China Ferry Terminal,Arrival,548,980,111,1639
4/11/2023,China Ferry Terminal,Departure,1120,591,47,1758
5/11/2023,China Ferry Terminal,Arrival,1491,564,86,2141
5/11/2023,China Ferry Terminal,Departure,451,792,73,1316
6/11/2023,China Ferry Terminal,Arrival,590,559,70,1219
6/11/2023,China Ferry Terminal,Departure,677,382,82,1141
7/11/2023,China Ferry Terminal,Arrival,502,607,90,1199
7/11/2023,China Ferry Terminal,Departure,556,435,68,1059
8/11/2023,China Ferry Terminal,Arrival,555,539,71,1165
8/11/2023,China Ferry Terminal,Departure,657,487,54,1198
9/11/2023,China Ferry Terminal,Arrival,594,542,67,1203
9/11/2023,China Ferry Terminal,Departure,664,471,58,1193
10/11/2023,China Ferry Terminal,Arrival,763,562,110,1435
10/11/2023,China Ferry Terminal,Departure,1111,537,55,1703
11/11/2023,China Ferry Terminal,Arrival,549,1022,101,1672
11/11/2023,China Ferry Terminal,Departure,1135,607,60,1802
12/11/2023,China Ferry Terminal,Arrival,1443,510,72,2025
12/11/2023,China Ferry Terminal,Departure,561,801,92,1454
13-11-2023,China Ferry Terminal,Arrival,704,597,58,1359
13-11-2023,China Ferry Terminal,Departure,739,481,89,1309
14-11-2023,China Ferry Terminal,Arrival,588,639,78,1305
14-11-2023,China Ferry Terminal,Departure,619,444,107,1170
15-11-2023,China Ferry Terminal,Arrival,536,631,64,1231
15-11-2023,China Ferry Terminal,Departure,726,593,70,1389
16-11-2023,China Ferry Terminal,Arrival,589,672,80,1341
16-11-2023,China Ferry Terminal,Departure,776,674,86,1536
17-11-2023,China Ferry Terminal,Arrival,761,769,126,1656
17-11-2023,China Ferry Terminal,Departure,1235,652,66,1953
18-11-2023,China Ferry Terminal,Arrival,689,1056,109,1854
18-11-2023,China Ferry Terminal,Departure,1427,626,51,2104
19-11-2023,China Ferry Terminal,Arrival,1842,627,104,2573
19-11-2023,China Ferry Terminal,Departure,572,1004,96,1672
20-11-2023,China Ferry Terminal,Arrival,844,677,66,1587
20-11-2023,China Ferry Terminal,Departure,780,541,80,1401
21-11-2023,China Ferry Terminal,Arrival,618,614,75,1307
21-11-2023,China Ferry Terminal,Departure,651,530,64,1245
22-11-2023,China Ferry Terminal,Arrival,628,549,57,1234
22-11-2023,China Ferry Terminal,Departure,770,561,67,1398
23-11-2023,China Ferry Terminal,Arrival,752,616,97,1465
23-11-2023,China Ferry Terminal,Departure,752,579,63,1394
24-11-2023,China Ferry Terminal,Arrival,832,675,104,1611
24-11-2023,China Ferry Terminal,Departure,1196,526,50,1772
25-11-2023,China Ferry Terminal,Arrival,745,992,124,1861
25-11-2023,China Ferry Terminal,Departure,1560,615,57,2232
26-11-2023,China Ferry Terminal,Arrival,1807,487,78,2372
26-11-2023,China Ferry Terminal,Departure,579,1072,113,1764
27-11-2023,China Ferry Terminal,Arrival,863,633,76,1572
27-11-2023,China Ferry Terminal,Departure,797,524,81,1402
28-11-2023,China Ferry Terminal,Arrival,530,523,53,1106
28-11-2023,China Ferry Terminal,Departure,641,549,47,1237
29-11-2023,China Ferry Terminal,Arrival,624,550,83,1257
29-11-2023,China Ferry Terminal,Departure,662,470,48,1180
30-11-2023,China Ferry Terminal,Arrival,734,543,83,1360
30-11-2023,China Ferry Terminal,Departure,679,502,42,1223
1/12/2023,China Ferry Terminal,Arrival,928,663,168,1759
1/12/2023,China Ferry Terminal,Departure,1417,580,147,2144
2/12/2023,China Ferry Terminal,Arrival,722,1081,189,1992
2/12/2023,China Ferry Terminal,Departure,1543,686,140,2369
3/12/2023,China Ferry Terminal,Arrival,1844,703,108,2655
3/12/2023,China Ferry Terminal,Departure,623,976,96,1695
4/12/2023,China Ferry Terminal,Arrival,928,601,150,1679
4/12/2023,China Ferry Terminal,Departure,753,569,82,1404
5/12/2023,China Ferry Terminal,Arrival,676,683,149,1508
5/12/2023,China Ferry Terminal,Departure,643,523,145,1311
6/12/2023,China Ferry Terminal,Arrival,567,607,178,1352
6/12/2023,China Ferry Terminal,Departure,660,572,116,1348
7/12/2023,China Ferry Terminal,Arrival,607,603,163,1373
7/12/2023,China Ferry Terminal,Departure,659,661,112,1432
8/12/2023,China Ferry Terminal,Arrival,976,764,168,1908
8/12/2023,China Ferry Terminal,Departure,1083,665,123,1871
9/12/2023,China Ferry Terminal,Arrival,670,1432,193,2295
9/12/2023,China Ferry Terminal,Departure,1305,734,161,2200
10/12/2023,China Ferry Terminal,Arrival,1356,741,209,2306
10/12/2023,China Ferry Terminal,Departure,773,1134,166,2073
11/12/2023,China Ferry Terminal,Arrival,1274,815,176,2265
11/12/2023,China Ferry Terminal,Departure,750,733,174,1657
12/12/2023,China Ferry Terminal,Arrival,647,724,126,1497
12/12/2023,China Ferry Terminal,Departure,834,775,135,1744
13-12-2023,China Ferry Terminal,Arrival,689,793,145,1627
13-12-2023,China Ferry Terminal,Departure,637,666,174,1477
14-12-2023,China Ferry Terminal,Arrival,813,779,190,1782
14-12-2023,China Ferry Terminal,Departure,720,785,143,1648
15-12-2023,China Ferry Terminal,Arrival,976,936,193,2105
15-12-2023,China Ferry Terminal,Departure,1253,795,140,2188
16-12-2023,China Ferry Terminal,Arrival,723,1029,184,1936
16-12-2023,China Ferry Terminal,Departure,1212,733,174,2119
17-12-2023,China Ferry Terminal,Arrival,1481,921,169,2571
17-12-2023,China Ferry Terminal,Departure,738,1298,229,2265
18-12-2023,China Ferry Terminal,Arrival,773,938,139,1850
18-12-2023,China Ferry Terminal,Departure,823,740,131,1694
19-12-2023,China Ferry Terminal,Arrival,714,760,180,1654
19-12-2023,China Ferry Terminal,Departure,749,749,172,1670
20-12-2023,China Ferry Terminal,Arrival,717,860,183,1760
20-12-2023,China Ferry Terminal,Departure,819,810,196,1825
21-12-2023,China Ferry Terminal,Arrival,662,835,169,1666
21-12-2023,China Ferry Terminal,Departure,1041,912,167,2120
22-12-2023,China Ferry Terminal,Arrival,738,669,181,1588
22-12-2023,China Ferry Terminal,Departure,2153,734,148,3035
23-12-2023,China Ferry Terminal,Arrival,604,1550,266,2420
23-12-2023,China Ferry Terminal,Departure,4106,871,229,5206
24-12-2023,China Ferry Terminal,Arrival,881,1054,208,2143
24-12-2023,China Ferry Terminal,Departure,3250,1415,223,4888
25-12-2023,China Ferry Terminal,Arrival,2634,783,131,3548
25-12-2023,China Ferry Terminal,Departure,1490,780,147,2417
26-12-2023,China Ferry Terminal,Arrival,4220,604,183,5007
26-12-2023,China Ferry Terminal,Departure,951,623,239,1813
27-12-2023,China Ferry Terminal,Arrival,1575,681,240,2496
27-12-2023,China Ferry Terminal,Departure,1077,753,283,2113
28-12-2023,China Ferry Terminal,Arrival,1137,700,332,2169
28-12-2023,China Ferry Terminal,Departure,1056,663,327,2046
29-12-2023,China Ferry Terminal,Arrival,1311,879,342,2532
29-12-2023,China Ferry Terminal,Departure,1294,786,277,2357
30-12-2023,China Ferry Terminal,Arrival,1338,1648,357,3343
30-12-2023,China Ferry Terminal,Departure,2097,1000,322,3419
31-12-2023,China Ferry Terminal,Arrival,1265,2139,213,3617
31-12-2023,China Ferry Terminal,Departure,946,1016,140,2102
1/1/2024,China Ferry Terminal,Arrival,2661,812,193,3666
1/1/2024,China Ferry Terminal,Departure,539,1733,226,2498
2/1/2024,China Ferry Terminal,Arrival,992,620,219,1831
2/1/2024,China Ferry Terminal,Departure,692,608,277,1577
3/1/2024,China Ferry Terminal,Arrival,616,644,232,1492
3/1/2024,China Ferry Terminal,Departure,557,537,193,1287
4/1/2024,China Ferry Terminal,Arrival,574,595,215,1384
4/1/2024,China Ferry Terminal,Departure,562,651,207,1420
5/1/2024,China Ferry Terminal,Arrival,778,628,271,1677
5/1/2024,China Ferry Terminal,Departure,951,597,202,1750
6/1/2024,China Ferry Terminal,Arrival,660,1041,261,1962
6/1/2024,China Ferry Terminal,Departure,1116,654,223,1993
7/1/2024,China Ferry Terminal,Arrival,1303,834,206,2343
7/1/2024,China Ferry Terminal,Departure,554,738,260,1552
8/1/2024,China Ferry Terminal,Arrival,630,730,183,1543
8/1/2024,China Ferry Terminal,Departure,712,641,189,1542
9/1/2024,China Ferry Terminal,Arrival,563,700,177,1440
9/1/2024,China Ferry Terminal,Departure,597,684,182,1463
10/1/2024,China Ferry Terminal,Arrival,676,943,218,1837
10/1/2024,China Ferry Terminal,Departure,590,685,217,1492
11/1/2024,China Ferry Terminal,Arrival,568,683,217,1468
11/1/2024,China Ferry Terminal,Departure,631,914,200,1745
12/1/2024,China Ferry Terminal,Arrival,717,736,238,1691
12/1/2024,China Ferry Terminal,Departure,935,741,196,1872
13-01-2024,China Ferry Terminal,Arrival,652,1210,247,2109
13-01-2024,China Ferry Terminal,Departure,1070,816,219,2105
14-01-2024,China Ferry Terminal,Arrival,1515,872,150,2537
14-01-2024,China Ferry Terminal,Departure,605,1227,195,2027
15-01-2024,China Ferry Terminal,Arrival,690,785,236,1711
15-01-2024,China Ferry Terminal,Departure,693,745,248,1686
16-01-2024,China Ferry Terminal,Arrival,615,799,172,1586
16-01-2024,China Ferry Terminal,Departure,631,844,163,1638
17-01-2024,China Ferry Terminal,Arrival,642,895,184,1721
17-01-2024,China Ferry Terminal,Departure,800,892,187,1879
18-01-2024,China Ferry Terminal,Arrival,614,946,337,1897
18-01-2024,China Ferry Terminal,Departure,666,866,295,1827
19-01-2024,China Ferry Terminal,Arrival,951,911,329,2191
19-01-2024,China Ferry Terminal,Departure,1187,1002,369,2558
20-01-2024,China Ferry Terminal,Arrival,708,1317,238,2263
20-01-2024,China Ferry Terminal,Departure,1373,1133,225,2731
21-01-2024,China Ferry Terminal,Arrival,1530,1340,190,3060
21-01-2024,China Ferry Terminal,Departure,738,1362,366,2466
22-01-2024,China Ferry Terminal,Arrival,850,1153,225,2228
22-01-2024,China Ferry Terminal,Departure,832,1181,331,2344
23-01-2024,China Ferry Terminal,Arrival,695,865,165,1725
23-01-2024,China Ferry Terminal,Departure,610,1224,191,2025
24-01-2024,China Ferry Terminal,Arrival,564,939,141,1644
24-01-2024,China Ferry Terminal,Departure,626,1152,307,2085
25-01-2024,China Ferry Terminal,Arrival,599,1135,238,1972
25-01-2024,China Ferry Terminal,Departure,619,1181,316,2116
26-01-2024,China Ferry Terminal,Arrival,705,1218,270,2193
26-01-2024,China Ferry Terminal,Departure,1129,1417,224,2770
27-01-2024,China Ferry Terminal,Arrival,634,1565,214,2413
27-01-2024,China Ferry Terminal,Departure,1309,1352,351,3012
28-01-2024,China Ferry Terminal,Arrival,1556,1774,227,3557
28-01-2024,China Ferry Terminal,Departure,565,1772,319,2656
29-01-2024,China Ferry Terminal,Arrival,789,1378,160,2327
29-01-2024,China Ferry Terminal,Departure,792,1241,292,2325
30-01-2024,China Ferry Terminal,Arrival,648,1189,215,2052
30-01-2024,China Ferry Terminal,Departure,707,1410,278,2395
31-01-2024,China Ferry Terminal,Arrival,739,1390,227,2356
31-01-2024,China Ferry Terminal,Departure,674,1476,229,2379
1/2/2024,China Ferry Terminal,Arrival,654,1562,200,2416
1/2/2024,China Ferry Terminal,Departure,736,1645,233,2614
2/2/2024,China Ferry Terminal,Arrival,764,1371,182,2317
2/2/2024,China Ferry Terminal,Departure,1008,1590,207,2805
3/2/2024,China Ferry Terminal,Arrival,647,1933,264,2844
3/2/2024,China Ferry Terminal,Departure,1095,1919,292,3306
4/2/2024,China Ferry Terminal,Arrival,1106,2194,223,3523
4/2/2024,China Ferry Terminal,Departure,685,1794,271,2750
5/2/2024,China Ferry Terminal,Arrival,749,2201,190,3140
5/2/2024,China Ferry Terminal,Departure,806,2274,217,3297
6/2/2024,China Ferry Terminal,Arrival,618,2137,172,2927
6/2/2024,China Ferry Terminal,Departure,1063,2480,190,3733
7/2/2024,China Ferry Terminal,Arrival,534,1759,157,2450
7/2/2024,China Ferry Terminal,Departure,1828,2557,192,4577
8/2/2024,China Ferry Terminal,Arrival,582,1256,174,2012
8/2/2024,China Ferry Terminal,Departure,2459,2248,223,4930
9/2/2024,China Ferry Terminal,Arrival,407,974,143,1524
9/2/2024,China Ferry Terminal,Departure,3841,1181,200,5222
10/2/2024,China Ferry Terminal,Arrival,367,1684,209,2260
10/2/2024,China Ferry Terminal,Departure,3018,1421,242,4681
11/2/2024,China Ferry Terminal,Arrival,933,2751,257,3941
11/2/2024,China Ferry Terminal,Departure,2730,1838,237,4805
12/2/2024,China Ferry Terminal,Arrival,2526,3047,169,5742
12/2/2024,China Ferry Terminal,Departure,2270,2553,224,5047
13-02-2024,China Ferry Terminal,Arrival,3803,3168,190,7161
13-02-2024,China Ferry Terminal,Departure,1198,2680,188,4066
14-02-2024,China Ferry Terminal,Arrival,2715,3215,166,6096
14-02-2024,China Ferry Terminal,Departure,1032,2734,239,4005
15-02-2024,China Ferry Terminal,Arrival,2020,3177,186,5383
15-02-2024,China Ferry Terminal,Departure,1053,2919,170,4142
16-02-2024,China Ferry Terminal,Arrival,1898,2591,232,4721
16-02-2024,China Ferry Terminal,Departure,1207,2901,211,4319
17-02-2024,China Ferry Terminal,Arrival,2127,1759,200,4086
17-02-2024,China Ferry Terminal,Departure,1268,2585,197,4050
18-02-2024,China Ferry Terminal,Arrival,2758,1339,112,4209
18-02-2024,China Ferry Terminal,Departure,611,1807,156,2574
19-02-2024,China Ferry Terminal,Arrival,967,1059,173,2199
19-02-2024,China Ferry Terminal,Departure,626,1379,177,2182
20-02-2024,China Ferry Terminal,Arrival,660,840,211,1711
20-02-2024,China Ferry Terminal,Departure,632,1159,177,1968
21-02-2024,China Ferry Terminal,Arrival,645,949,190,1784
21-02-2024,China Ferry Terminal,Departure,561,985,177,1723
22-02-2024,China Ferry Terminal,Arrival,608,829,188,1625
22-02-2024,China Ferry Terminal,Departure,617,869,280,1766
23-02-2024,China Ferry Terminal,Arrival,706,739,295,1740
23-02-2024,China Ferry Terminal,Departure,1094,913,341,2348
24-02-2024,China Ferry Terminal,Arrival,725,844,237,1806
24-02-2024,China Ferry Terminal,Departure,1254,814,313,2381
25-02-2024,China Ferry Terminal,Arrival,1492,663,246,2401
25-02-2024,China Ferry Terminal,Departure,695,900,320,1915
26-02-2024,China Ferry Terminal,Arrival,794,608,317,1719
26-02-2024,China Ferry Terminal,Departure,755,514,374,1643
27-02-2024,China Ferry Terminal,Arrival,644,587,256,1487
27-02-2024,China Ferry Terminal,Departure,658,700,279,1637
28-02-2024,China Ferry Terminal,Arrival,632,589,360,1581
28-02-2024,China Ferry Terminal,Departure,642,587,384,1613
29-02-2024,China Ferry Terminal,Arrival,608,522,218,1348
29-02-2024,China Ferry Terminal,Departure,667,516,245,1428
1/3/2024,China Ferry Terminal,Arrival,703,625,342,1670
1/3/2024,China Ferry Terminal,Departure,1036,578,309,1923
2/3/2024,China Ferry Terminal,Arrival,603,763,262,1628
2/3/2024,China Ferry Terminal,Departure,1069,604,276,1949
3/3/2024,China Ferry Terminal,Arrival,1249,539,235,2023
3/3/2024,China Ferry Terminal,Departure,589,659,317,1565
4/3/2024,China Ferry Terminal,Arrival,718,464,194,1376
4/3/2024,China Ferry Terminal,Departure,774,399,366,1539
5/3/2024,China Ferry Terminal,Arrival,578,524,165,1267
5/3/2024,China Ferry Terminal,Departure,612,494,211,1317
6/3/2024,China Ferry Terminal,Arrival,582,413,265,1260
6/3/2024,China Ferry Terminal,Departure,707,497,275,1479
7/3/2024,China Ferry Terminal,Arrival,587,439,188,1214
7/3/2024,China Ferry Terminal,Departure,670,487,264,1421
8/3/2024,China Ferry Terminal,Arrival,755,914,301,1970
8/3/2024,China Ferry Terminal,Departure,1031,656,271,1958
9/3/2024,China Ferry Terminal,Arrival,629,930,271,1830
9/3/2024,China Ferry Terminal,Departure,1179,651,253,2083
10/3/2024,China Ferry Terminal,Arrival,1399,507,264,2170
10/3/2024,China Ferry Terminal,Departure,634,842,385,1861
11/3/2024,China Ferry Terminal,Arrival,682,409,249,1340
11/3/2024,China Ferry Terminal,Departure,694,439,324,1457
12/3/2024,China Ferry Terminal,Arrival,557,577,223,1357
12/3/2024,China Ferry Terminal,Departure,663,518,198,1379
13-03-2024,China Ferry Terminal,Arrival,584,590,239,1413
13-03-2024,China Ferry Terminal,Departure,698,550,318,1566
14-03-2024,China Ferry Terminal,Arrival,616,552,236,1404
14-03-2024,China Ferry Terminal,Departure,660,602,275,1537
15-03-2024,China Ferry Terminal,Arrival,750,752,252,1754
15-03-2024,China Ferry Terminal,Departure,1079,674,297,2050
16-03-2024,China Ferry Terminal,Arrival,756,996,308,2060
16-03-2024,China Ferry Terminal,Departure,1179,724,316,2219
17-03-2024,China Ferry Terminal,Arrival,1284,657,198,2139
17-03-2024,China Ferry Terminal,Departure,704,933,328,1965
18-03-2024,China Ferry Terminal,Arrival,697,376,244,1317
18-03-2024,China Ferry Terminal,Departure,618,416,233,1267
19-03-2024,China Ferry Terminal,Arrival,541,509,197,1247
19-03-2024,China Ferry Terminal,Departure,686,719,241,1646
20-03-2024,China Ferry Terminal,Arrival,570,684,219,1473
20-03-2024,China Ferry Terminal,Departure,701,713,289,1703
21-03-2024,China Ferry Terminal,Arrival,673,575,252,1500
21-03-2024,China Ferry Terminal,Departure,798,703,246,1747
22-03-2024,China Ferry Terminal,Arrival,746,708,290,1744
22-03-2024,China Ferry Terminal,Departure,980,676,228,1884
23-03-2024,China Ferry Terminal,Arrival,688,1312,332,2332
23-03-2024,China Ferry Terminal,Departure,1259,903,283,2445
24-03-2024,China Ferry Terminal,Arrival,1307,678,238,2223
24-03-2024,China Ferry Terminal,Departure,699,1114,274,2087
25-03-2024,China Ferry Terminal,Arrival,715,631,284,1630
25-03-2024,China Ferry Terminal,Departure,769,621,285,1675
26-03-2024,China Ferry Terminal,Arrival,624,678,269,1571
26-03-2024,China Ferry Terminal,Departure,902,648,249,1799
27-03-2024,China Ferry Terminal,Arrival,628,662,239,1529
27-03-2024,China Ferry Terminal,Departure,1148,738,286,2172
28-03-2024,China Ferry Terminal,Arrival,695,655,224,1574
28-03-2024,China Ferry Terminal,Departure,3017,806,321,4144
29-03-2024,China Ferry Terminal,Arrival,785,667,318,1770
29-03-2024,China Ferry Terminal,Departure,6052,825,299,7176
30-03-2024,China Ferry Terminal,Arrival,1471,963,296,2730
30-03-2024,China Ferry Terminal,Departure,3339,703,319,4361
31-03-2024,China Ferry Terminal,Arrival,3931,558,224,4713
31-03-2024,China Ferry Terminal,Departure,1781,843,255,2879
1/4/2024,China Ferry Terminal,Arrival,4977,540,205,5722
1/4/2024,China Ferry Terminal,Departure,1299,482,214,1995
2/4/2024,China Ferry Terminal,Arrival,1519,575,252,2346
2/4/2024,China Ferry Terminal,Departure,1284,675,233,2192
3/4/2024,China Ferry Terminal,Arrival,1427,723,276,2426
3/4/2024,China Ferry Terminal,Departure,2719,755,270,3744
4/4/2024,China Ferry Terminal,Arrival,1928,2119,288,4335
4/4/2024,China Ferry Terminal,Departure,1855,841,232,2928
5/4/2024,China Ferry Terminal,Arrival,1959,2018,353,4330
5/4/2024,China Ferry Terminal,Departure,1482,1499,308,3289
6/4/2024,China Ferry Terminal,Arrival,2040,729,338,3107
6/4/2024,China Ferry Terminal,Departure,1570,1532,338,3440
7/4/2024,China Ferry Terminal,Arrival,2966,701,209,3876
7/4/2024,China Ferry Terminal,Departure,728,692,340,1760
8/4/2024,China Ferry Terminal,Arrival,1135,683,337,2155
8/4/2024,China Ferry Terminal,Departure,779,695,409,1883
9/4/2024,China Ferry Terminal,Arrival,773,651,237,1661
9/4/2024,China Ferry Terminal,Departure,618,1184,251,2053
10/4/2024,China Ferry Terminal,Arrival,677,531,271,1479
10/4/2024,China Ferry Terminal,Departure,699,571,252,1522
11/4/2024,China Ferry Terminal,Arrival,623,624,431,1678
11/4/2024,China Ferry Terminal,Departure,813,611,341,1765
12/4/2024,China Ferry Terminal,Arrival,866,845,388,2099
12/4/2024,China Ferry Terminal,Departure,1759,664,425,2848
13-04-2024,China Ferry Terminal,Arrival,874,1203,396,2473
13-04-2024,China Ferry Terminal,Departure,2483,894,394,3771
14-04-2024,China Ferry Terminal,Arrival,2507,715,330,3552
14-04-2024,China Ferry Terminal,Departure,1149,865,563,2577
15-04-2024,China Ferry Terminal,Arrival,1422,654,219,2295
15-04-2024,China Ferry Terminal,Departure,832,608,415,1855
16-04-2024,China Ferry Terminal,Arrival,658,630,230,1518
16-04-2024,China Ferry Terminal,Departure,604,812,281,1697
17-04-2024,China Ferry Terminal,Arrival,642,660,302,1604
17-04-2024,China Ferry Terminal,Departure,772,655,323,1750
18-04-2024,China Ferry Terminal,Arrival,758,647,227,1632
18-04-2024,China Ferry Terminal,Departure,810,712,257,1779
19-04-2024,China Ferry Terminal,Arrival,800,653,385,1838
19-04-2024,China Ferry Terminal,Departure,1549,722,273,2544
20-04-2024,China Ferry Terminal,Arrival,777,813,373,1963
20-04-2024,China Ferry Terminal,Departure,1838,754,364,2956
21-04-2024,China Ferry Terminal,Arrival,1743,303,225,2271
21-04-2024,China Ferry Terminal,Departure,611,633,288,1532
22-04-2024,China Ferry Terminal,Arrival,851,454,228,1533
22-04-2024,China Ferry Terminal,Departure,708,411,312,1431
23-04-2024,China Ferry Terminal,Arrival,587,431,259,1277
23-04-2024,China Ferry Terminal,Departure,591,476,309,1376
24-04-2024,China Ferry Terminal,Arrival,535,549,270,1354
24-04-2024,China Ferry Terminal,Departure,810,529,266,1605
25-04-2024,China Ferry Terminal,Arrival,574,496,255,1325
25-04-2024,China Ferry Terminal,Departure,653,522,172,1347
26-04-2024,China Ferry Terminal,Arrival,971,530,274,1775
26-04-2024,China Ferry Terminal,Departure,1184,597,196,1977
27-04-2024,China Ferry Terminal,Arrival,743,579,328,1650
27-04-2024,China Ferry Terminal,Departure,1397,488,240,2125
28-04-2024,China Ferry Terminal,Arrival,1611,530,280,2421
28-04-2024,China Ferry Terminal,Departure,700,504,326,1530
29-04-2024,China Ferry Terminal,Arrival,819,742,283,1844
29-04-2024,China Ferry Terminal,Departure,846,701,325,1872
30-04-2024,China Ferry Terminal,Arrival,1007,1044,338,2389
30-04-2024,China Ferry Terminal,Departure,861,838,336,2035
1/5/2024,China Ferry Terminal,Arrival,898,2388,169,3455
1/5/2024,China Ferry Terminal,Departure,632,1015,193,1840
2/5/2024,China Ferry Terminal,Arrival,740,2342,309,3391
2/5/2024,China Ferry Terminal,Departure,661,1838,255,2754
3/5/2024,China Ferry Terminal,Arrival,727,2195,384,3306
3/5/2024,China Ferry Terminal,Departure,1025,2295,309,3629
4/5/2024,China Ferry Terminal,Arrival,601,1093,303,1997
4/5/2024,China Ferry Terminal,Departure,1038,1771,306,3115
5/5/2024,China Ferry Terminal,Arrival,1420,514,300,2234
5/5/2024,China Ferry Terminal,Departure,660,1108,373,2141
6/5/2024,China Ferry Terminal,Arrival,718,538,197,1453
6/5/2024,China Ferry Terminal,Departure,827,512,248,1587
7/5/2024,China Ferry Terminal,Arrival,612,494,186,1292
7/5/2024,China Ferry Terminal,Departure,685,452,138,1275
8/5/2024,China Ferry Terminal,Arrival,608,465,274,1347
8/5/2024,China Ferry Terminal,Departure,666,481,217,1364
9/5/2024,China Ferry Terminal,Arrival,585,516,178,1279
9/5/2024,China Ferry Terminal,Departure,597,582,188,1367
10/5/2024,China Ferry Terminal,Arrival,808,506,223,1537
10/5/2024,China Ferry Terminal,Departure,1078,638,185,1901
11/5/2024,China Ferry Terminal,Arrival,715,459,252,1426
11/5/2024,China Ferry Terminal,Departure,1355,535,225,2115
12/5/2024,China Ferry Terminal,Arrival,1436,547,229,2212
12/5/2024,China Ferry Terminal,Departure,590,506,298,1394
13-05-2024,China Ferry Terminal,Arrival,692,530,179,1401
13-05-2024,China Ferry Terminal,Departure,874,429,242,1545
14-05-2024,China Ferry Terminal,Arrival,564,452,172,1188
14-05-2024,China Ferry Terminal,Departure,922,470,259,1651
15-05-2024,China Ferry Terminal,Arrival,981,413,261,1655
15-05-2024,China Ferry Terminal,Departure,866,493,217,1576
16-05-2024,China Ferry Terminal,Arrival,806,570,232,1608
16-05-2024,China Ferry Terminal,Departure,768,566,196,1530
17-05-2024,China Ferry Terminal,Arrival,891,612,253,1756
17-05-2024,China Ferry Terminal,Departure,1153,645,274,2072
18-05-2024,China Ferry Terminal,Arrival,711,904,218,1833
18-05-2024,China Ferry Terminal,Departure,1495,640,172,2307
19-05-2024,China Ferry Terminal,Arrival,1591,453,194,2238
19-05-2024,China Ferry Terminal,Departure,685,805,266,1756
20-05-2024,China Ferry Terminal,Arrival,721,417,171,1309
20-05-2024,China Ferry Terminal,Departure,700,479,248,1427
21-05-2024,China Ferry Terminal,Arrival,568,461,201,1230
21-05-2024,China Ferry Terminal,Departure,607,389,168,1164
22-05-2024,China Ferry Terminal,Arrival,501,477,219,1197
22-05-2024,China Ferry Terminal,Departure,561,573,231,1365
23-05-2024,China Ferry Terminal,Arrival,634,447,257,1338
23-05-2024,China Ferry Terminal,Departure,673,521,281,1475
24-05-2024,China Ferry Terminal,Arrival,741,652,333,1726
24-05-2024,China Ferry Terminal,Departure,1181,578,290,2049
25-05-2024,China Ferry Terminal,Arrival,806,757,255,1818
25-05-2024,China Ferry Terminal,Departure,1122,576,246,1944
26-05-2024,China Ferry Terminal,Arrival,1350,512,221,2083
26-05-2024,China Ferry Terminal,Departure,616,852,309,1777
27-05-2024,China Ferry Terminal,Arrival,662,440,205,1307
27-05-2024,China Ferry Terminal,Departure,801,581,203,1585
28-05-2024,China Ferry Terminal,Arrival,606,474,207,1287
28-05-2024,China Ferry Terminal,Departure,637,449,302,1388
29-05-2024,China Ferry Terminal,Arrival,522,514,165,1201
29-05-2024,China Ferry Terminal,Departure,650,581,343,1574
30-05-2024,China Ferry Terminal,Arrival,645,489,231,1365
30-05-2024,China Ferry Terminal,Departure,672,526,241,1439
31-05-2024,China Ferry Terminal,Arrival,646,440,195,1281
31-05-2024,China Ferry Terminal,Departure,811,486,132,1429
1/6/2024,China Ferry Terminal,Arrival,387,414,95,896
1/6/2024,China Ferry Terminal,Departure,714,256,116,1086
2/6/2024,China Ferry Terminal,Arrival,1106,298,62,1466
2/6/2024,China Ferry Terminal,Departure,464,540,114,1118
3/6/2024,China Ferry Terminal,Arrival,553,377,79,1009
3/6/2024,China Ferry Terminal,Departure,590,276,129,995
4/6/2024,China Ferry Terminal,Arrival,466,355,74,895
4/6/2024,China Ferry Terminal,Departure,538,375,97,1010
5/6/2024,China Ferry Terminal,Arrival,480,427,67,974
5/6/2024,China Ferry Terminal,Departure,480,336,113,929
6/6/2024,China Ferry Terminal,Arrival,571,497,130,1198
6/6/2024,China Ferry Terminal,Departure,582,412,143,1137
7/6/2024,China Ferry Terminal,Arrival,623,538,166,1327
7/6/2024,China Ferry Terminal,Departure,1592,579,141,2312
8/6/2024,China Ferry Terminal,Arrival,660,1204,198,2062
8/6/2024,China Ferry Terminal,Departure,3011,667,173,3851
9/6/2024,China Ferry Terminal,Arrival,761,931,91,1783
9/6/2024,China Ferry Terminal,Departure,1328,792,124,2244
10/6/2024,China Ferry Terminal,Arrival,3164,401,106,3671
10/6/2024,China Ferry Terminal,Departure,472,820,196,1488
11/6/2024,China Ferry Terminal,Arrival,1002,405,99,1506
11/6/2024,China Ferry Terminal,Departure,611,281,102,994
12/6/2024,China Ferry Terminal,Arrival,608,518,109,1235
12/6/2024,China Ferry Terminal,Departure,693,370,167,1230
13-06-2024,China Ferry Terminal,Arrival,669,630,153,1452
13-06-2024,China Ferry Terminal,Departure,561,495,110,1166
14-06-2024,China Ferry Terminal,Arrival,707,572,175,1454
14-06-2024,China Ferry Terminal,Departure,902,642,178,1722
15-06-2024,China Ferry Terminal,Arrival,565,602,138,1305
15-06-2024,China Ferry Terminal,Departure,947,485,139,1571
16-06-2024,China Ferry Terminal,Arrival,1123,347,111,1581
16-06-2024,China Ferry Terminal,Departure,529,560,156,1245
17-06-2024,China Ferry Terminal,Arrival,623,495,119,1237
17-06-2024,China Ferry Terminal,Departure,671,615,140,1426
18-06-2024,China Ferry Terminal,Arrival,538,480,118,1136
18-06-2024,China Ferry Terminal,Departure,602,429,116,1147
19-06-2024,China Ferry Terminal,Arrival,498,443,166,1107
19-06-2024,China Ferry Terminal,Departure,578,460,170,1208
20-06-2024,China Ferry Terminal,Arrival,541,517,177,1235
20-06-2024,China Ferry Terminal,Departure,677,483,139,1299
21-06-2024,China Ferry Terminal,Arrival,787,531,116,1434
21-06-2024,China Ferry Terminal,Departure,900,557,113,1570
22-06-2024,China Ferry Terminal,Arrival,704,744,113,1561
22-06-2024,China Ferry Terminal,Departure,969,579,120,1668
23-06-2024,China Ferry Terminal,Arrival,1162,607,105,1874
23-06-2024,China Ferry Terminal,Departure,528,620,141,1289
24-06-2024,China Ferry Terminal,Arrival,625,451,104,1180
24-06-2024,China Ferry Terminal,Departure,700,543,178,1421
25-06-2024,China Ferry Terminal,Arrival,483,438,111,1032
25-06-2024,China Ferry Terminal,Departure,589,433,126,1148
26-06-2024,China Ferry Terminal,Arrival,521,510,95,1126
26-06-2024,China Ferry Terminal,Departure,633,441,113,1187
27-06-2024,China Ferry Terminal,Arrival,537,473,127,1137
27-06-2024,China Ferry Terminal,Departure,789,531,206,1526
28-06-2024,China Ferry Terminal,Arrival,731,550,164,1445
28-06-2024,China Ferry Terminal,Departure,1336,559,172,2067
29-06-2024,China Ferry Terminal,Arrival,530,732,127,1389
29-06-2024,China Ferry Terminal,Departure,3298,563,131,3992
30-06-2024,China Ferry Terminal,Arrival,841,475,98,1414
30-06-2024,China Ferry Terminal,Departure,1365,520,113,1998
1/7/2024,China Ferry Terminal,Arrival,3573,385,76,4034
1/7/2024,China Ferry Terminal,Departure,429,362,110,901
2/7/2024,China Ferry Terminal,Arrival,719,471,94,1284
2/7/2024,China Ferry Terminal,Departure,504,589,109,1202
3/7/2024,China Ferry Terminal,Arrival,511,472,93,1076
3/7/2024,China Ferry Terminal,Departure,470,510,82,1062
4/7/2024,China Ferry Terminal,Arrival,415,431,132,978
4/7/2024,China Ferry Terminal,Departure,499,440,171,1110
5/7/2024,China Ferry Terminal,Arrival,541,510,139,1190
5/7/2024,China Ferry Terminal,Departure,751,494,156,1401
6/7/2024,China Ferry Terminal,Arrival,488,669,98,1255
6/7/2024,China Ferry Terminal,Departure,815,505,133,1453
7/7/2024,China Ferry Terminal,Arrival,1034,548,97,1679
7/7/2024,China Ferry Terminal,Departure,394,609,133,1136
8/7/2024,China Ferry Terminal,Arrival,570,614,81,1265
8/7/2024,China Ferry Terminal,Departure,580,449,116,1145
9/7/2024,China Ferry Terminal,Arrival,514,497,67,1078
9/7/2024,China Ferry Terminal,Departure,557,584,119,1260
10/7/2024,China Ferry Terminal,Arrival,488,605,79,1172
10/7/2024,China Ferry Terminal,Departure,540,582,105,1227
11/7/2024,China Ferry Terminal,Arrival,486,529,107,1122
11/7/2024,China Ferry Terminal,Departure,517,581,122,1220
12/7/2024,China Ferry Terminal,Arrival,565,605,108,1278
12/7/2024,China Ferry Terminal,Departure,950,677,96,1723
13-07-2024,China Ferry Terminal,Arrival,549,1117,127,1793
13-07-2024,China Ferry Terminal,Departure,1023,656,110,1789
14-07-2024,China Ferry Terminal,Arrival,1180,856,94,2130
14-07-2024,China Ferry Terminal,Departure,444,780,138,1362
15-07-2024,China Ferry Terminal,Arrival,592,670,100,1362
15-07-2024,China Ferry Terminal,Departure,640,677,147,1464
16-07-2024,China Ferry Terminal,Arrival,384,736,96,1216
16-07-2024,China Ferry Terminal,Departure,546,704,114,1364
17-07-2024,China Ferry Terminal,Arrival,494,788,113,1395
17-07-2024,China Ferry Terminal,Departure,622,650,142,1414
18-07-2024,China Ferry Terminal,Arrival,520,672,126,1318
18-07-2024,China Ferry Terminal,Departure,594,753,85,1432
19-07-2024,China Ferry Terminal,Arrival,628,748,97,1473
19-07-2024,China Ferry Terminal,Departure,1013,734,110,1857
20-07-2024,China Ferry Terminal,Arrival,538,1015,110,1663
20-07-2024,China Ferry Terminal,Departure,1003,734,131,1868
21-07-2024,China Ferry Terminal,Arrival,1174,802,102,2078
21-07-2024,China Ferry Terminal,Departure,451,946,97,1494
22-07-2024,China Ferry Terminal,Arrival,578,585,97,1260
22-07-2024,China Ferry Terminal,Departure,605,635,180,1420
23-07-2024,China Ferry Terminal,Arrival,507,713,64,1284
23-07-2024,China Ferry Terminal,Departure,579,561,102,1242
24-07-2024,China Ferry Terminal,Arrival,458,766,81,1305
24-07-2024,China Ferry Terminal,Departure,500,699,115,1314
25-07-2024,China Ferry Terminal,Arrival,556,711,90,1357
25-07-2024,China Ferry Terminal,Departure,620,837,115,1572
26-07-2024,China Ferry Terminal,Arrival,597,771,93,1461
26-07-2024,China Ferry Terminal,Departure,896,718,93,1707
27-07-2024,China Ferry Terminal,Arrival,485,939,105,1529
27-07-2024,China Ferry Terminal,Departure,890,739,98,1727
28-07-2024,China Ferry Terminal,Arrival,1176,750,120,2046
28-07-2024,China Ferry Terminal,Departure,455,830,147,1432
29-07-2024,China Ferry Terminal,Arrival,578,706,109,1393
29-07-2024,China Ferry Terminal,Departure,561,604,131,1296
30-07-2024,China Ferry Terminal,Arrival,522,616,96,1234
30-07-2024,China Ferry Terminal,Departure,549,733,119,1401
31-07-2024,China Ferry Terminal,Arrival,481,574,73,1128
31-07-2024,China Ferry Terminal,Departure,462,659,106,1227
1/8/2024,China Ferry Terminal,Arrival,500,762,122,1384
1/8/2024,China Ferry Terminal,Departure,532,575,138,1245
2/8/2024,China Ferry Terminal,Arrival,577,734,120,1431
2/8/2024,China Ferry Terminal,Departure,949,711,143,1803
3/8/2024,China Ferry Terminal,Arrival,595,1174,161,1930
3/8/2024,China Ferry Terminal,Departure,1108,759,96,1963
4/8/2024,China Ferry Terminal,Arrival,1340,927,124,2391
4/8/2024,China Ferry Terminal,Departure,548,994,113,1655
5/8/2024,China Ferry Terminal,Arrival,656,862,72,1590
5/8/2024,China Ferry Terminal,Departure,629,785,113,1527
6/8/2024,China Ferry Terminal,Arrival,529,754,72,1355
6/8/2024,China Ferry Terminal,Departure,558,717,90,1365
7/8/2024,China Ferry Terminal,Arrival,511,809,84,1404
7/8/2024,China Ferry Terminal,Departure,505,746,124,1375
8/8/2024,China Ferry Terminal,Arrival,539,786,102,1427
8/8/2024,China Ferry Terminal,Departure,562,933,107,1602
9/8/2024,China Ferry Terminal,Arrival,631,787,129,1547
9/8/2024,China Ferry Terminal,Departure,890,877,67,1834
10/8/2024,China Ferry Terminal,Arrival,502,1228,138,1868
10/8/2024,China Ferry Terminal,Departure,1346,771,167,2284
11/8/2024,China Ferry Terminal,Arrival,1211,830,145,2186
11/8/2024,China Ferry Terminal,Departure,539,987,140,1666
12/8/2024,China Ferry Terminal,Arrival,710,825,79,1614
12/8/2024,China Ferry Terminal,Departure,526,660,160,1346
13-08-2024,China Ferry Terminal,Arrival,543,759,111,1413
13-08-2024,China Ferry Terminal,Departure,533,744,99,1376
14-08-2024,China Ferry Terminal,Arrival,513,732,92,1337
14-08-2024,China Ferry Terminal,Departure,576,722,134,1432
15-08-2024,China Ferry Terminal,Arrival,550,818,113,1481
15-08-2024,China Ferry Terminal,Departure,492,841,105,1438
16-08-2024,China Ferry Terminal,Arrival,606,758,161,1525
16-08-2024,China Ferry Terminal,Departure,869,809,136,1814
17-08-2024,China Ferry Terminal,Arrival,494,898,117,1509
17-08-2024,China Ferry Terminal,Departure,918,696,98,1712
18-08-2024,China Ferry Terminal,Arrival,1114,732,114,1960
18-08-2024,China Ferry Terminal,Departure,505,772,160,1437
19-08-2024,China Ferry Terminal,Arrival,757,723,76,1556
19-08-2024,China Ferry Terminal,Departure,657,639,116,1412
20-08-2024,China Ferry Terminal,Arrival,527,638,67,1232
20-08-2024,China Ferry Terminal,Departure,484,562,93,1139
21-08-2024,China Ferry Terminal,Arrival,500,679,79,1258
21-08-2024,China Ferry Terminal,Departure,484,699,127,1310
22-08-2024,China Ferry Terminal,Arrival,531,728,134,1393
22-08-2024,China Ferry Terminal,Departure,527,697,127,1351
23-08-2024,China Ferry Terminal,Arrival,565,923,155,1643
23-08-2024,China Ferry Terminal,Departure,886,854,133,1873
24-08-2024,China Ferry Terminal,Arrival,477,1218,137,1832
24-08-2024,China Ferry Terminal,Departure,1025,836,113,1974
25-08-2024,China Ferry Terminal,Arrival,1281,1035,138,2454
25-08-2024,China Ferry Terminal,Departure,448,978,216,1642
26-08-2024,China Ferry Terminal,Arrival,697,802,262,1761
26-08-2024,China Ferry Terminal,Departure,555,804,164,1523
27-08-2024,China Ferry Terminal,Arrival,565,865,66,1496
27-08-2024,China Ferry Terminal,Departure,600,762,125,1487
28-08-2024,China Ferry Terminal,Arrival,551,644,111,1306
28-08-2024,China Ferry Terminal,Departure,536,794,108,1438
29-08-2024,China Ferry Terminal,Arrival,623,623,90,1336
29-08-2024,China Ferry Terminal,Departure,540,651,116,1307
30-08-2024,China Ferry Terminal,Arrival,588,528,141,1257
30-08-2024,China Ferry Terminal,Departure,736,657,133,1526
31-08-2024,China Ferry Terminal,Arrival,555,651,101,1307
31-08-2024,China Ferry Terminal,Departure,865,537,114,1516
1/9/2024,China Ferry Terminal,Arrival,1109,310,20,1439
1/9/2024,China Ferry Terminal,Departure,365,421,28,814
2/9/2024,China Ferry Terminal,Arrival,454,267,82,803
2/9/2024,China Ferry Terminal,Departure,463,217,47,727
3/9/2024,China Ferry Terminal,Arrival,289,252,44,585
3/9/2024,China Ferry Terminal,Departure,372,244,45,661
4/9/2024,China Ferry Terminal,Arrival,368,342,36,746
4/9/2024,China Ferry Terminal,Departure,356,267,37,660
5/9/2024,China Ferry Terminal,Arrival,0,0,0,0
5/9/2024,China Ferry Terminal,Departure,0,0,0,0
6/9/2024,China Ferry Terminal,Arrival,0,0,0,0
6/9/2024,China Ferry Terminal,Departure,0,0,0,0
7/9/2024,China Ferry Terminal,Arrival,246,199,33,478
7/9/2024,China Ferry Terminal,Departure,377,159,15,551
8/9/2024,China Ferry Terminal,Arrival,598,315,26,939
8/9/2024,China Ferry Terminal,Departure,260,286,34,580
9/9/2024,China Ferry Terminal,Arrival,389,341,40,770
9/9/2024,China Ferry Terminal,Departure,489,233,55,777
10/9/2024,China Ferry Terminal,Arrival,325,357,34,716
10/9/2024,China Ferry Terminal,Departure,497,278,43,818
11/9/2024,China Ferry Terminal,Arrival,423,358,45,826
11/9/2024,China Ferry Terminal,Departure,393,359,103,855
12/9/2024,China Ferry Terminal,Arrival,430,344,41,815
12/9/2024,China Ferry Terminal,Departure,467,360,35,862
13-09-2024,China Ferry Terminal,Arrival,431,413,56,900
13-09-2024,China Ferry Terminal,Departure,822,350,41,1213
14-09-2024,China Ferry Terminal,Arrival,490,400,65,955
14-09-2024,China Ferry Terminal,Departure,1134,294,18,1446
15-09-2024,China Ferry Terminal,Arrival,1296,899,76,2271
15-09-2024,China Ferry Terminal,Departure,542,481,36,1059
16-09-2024,China Ferry Terminal,Arrival,584,830,53,1467
16-09-2024,China Ferry Terminal,Departure,617,656,65,1338
17-09-2024,China Ferry Terminal,Arrival,288,287,21,596
17-09-2024,China Ferry Terminal,Departure,917,530,62,1509
18-09-2024,China Ferry Terminal,Arrival,1185,318,38,1541
18-09-2024,China Ferry Terminal,Departure,517,271,48,836
19-09-2024,China Ferry Terminal,Arrival,562,338,110,1010
19-09-2024,China Ferry Terminal,Departure,484,317,49,850
20-09-2024,China Ferry Terminal,Arrival,485,367,41,893
20-09-2024,China Ferry Terminal,Departure,659,327,31,1017
21-09-2024,China Ferry Terminal,Arrival,373,678,119,1170
21-09-2024,China Ferry Terminal,Departure,707,520,31,1258
22-09-2024,China Ferry Terminal,Arrival,960,355,34,1349
22-09-2024,China Ferry Terminal,Departure,344,364,54,762
23-09-2024,China Ferry Terminal,Arrival,442,330,49,821
23-09-2024,China Ferry Terminal,Departure,485,256,42,783
24-09-2024,China Ferry Terminal,Arrival,336,351,31,718
24-09-2024,China Ferry Terminal,Departure,419,243,38,700
25-09-2024,China Ferry Terminal,Arrival,410,370,34,814
25-09-2024,China Ferry Terminal,Departure,449,307,49,805
26-09-2024,China Ferry Terminal,Arrival,439,363,76,878
26-09-2024,China Ferry Terminal,Departure,415,300,42,757
27-09-2024,China Ferry Terminal,Arrival,491,377,74,942
27-09-2024,China Ferry Terminal,Departure,858,390,51,1299
28-09-2024,China Ferry Terminal,Arrival,346,489,69,904
28-09-2024,China Ferry Terminal,Departure,979,376,30,1385
29-09-2024,China Ferry Terminal,Arrival,913,416,50,1379
29-09-2024,China Ferry Terminal,Departure,496,372,20,888
30-09-2024,China Ferry Terminal,Arrival,724,663,48,1435
30-09-2024,China Ferry Terminal,Departure,614,472,30,1116
1/10/2024,China Ferry Terminal,Arrival,1168,2073,64,3305
1/10/2024,China Ferry Terminal,Departure,389,577,14,980
2/10/2024,China Ferry Terminal,Arrival,602,1600,77,2279
2/10/2024,China Ferry Terminal,Departure,405,1448,47,1900
3/10/2024,China Ferry Terminal,Arrival,496,1830,112,2438
3/10/2024,China Ferry Terminal,Departure,567,1548,46,2161
4/10/2024,China Ferry Terminal,Arrival,481,1672,89,2242
4/10/2024,China Ferry Terminal,Departure,813,1253,74,2140
5/10/2024,China Ferry Terminal,Arrival,492,1402,78,1972
5/10/2024,China Ferry Terminal,Departure,767,1166,76,2009
6/10/2024,China Ferry Terminal,Arrival,1125,752,38,1915
6/10/2024,China Ferry Terminal,Departure,418,974,65,1457
7/10/2024,China Ferry Terminal,Arrival,628,784,56,1468
7/10/2024,China Ferry Terminal,Departure,625,761,67,1453
8/10/2024,China Ferry Terminal,Arrival,317,318,42,677
8/10/2024,China Ferry Terminal,Departure,531,249,70,850
9/10/2024,China Ferry Terminal,Arrival,403,278,51,732
9/10/2024,China Ferry Terminal,Departure,463,281,46,790
10/10/2024,China Ferry Terminal,Arrival,418,318,44,780
10/10/2024,China Ferry Terminal,Departure,1258,337,60,1655
11/10/2024,China Ferry Terminal,Arrival,426,236,58,720
11/10/2024,China Ferry Terminal,Departure,2471,228,37,2736
12/10/2024,China Ferry Terminal,Arrival,804,500,72,1376
12/10/2024,China Ferry Terminal,Departure,634,301,33,968
13-10-2024,China Ferry Terminal,Arrival,2972,381,46,3399
13-10-2024,China Ferry Terminal,Departure,300,351,70,721
14-10-2024,China Ferry Terminal,Arrival,580,447,40,1067
14-10-2024,China Ferry Terminal,Departure,461,355,150,966
15-10-2024,China Ferry Terminal,Arrival,419,348,46,813
15-10-2024,China Ferry Terminal,Departure,425,320,84,829
16-10-2024,China Ferry Terminal,Arrival,398,378,49,825
16-10-2024,China Ferry Terminal,Departure,407,427,75,909
17-10-2024,China Ferry Terminal,Arrival,340,388,93,821
17-10-2024,China Ferry Terminal,Departure,413,322,55,790
18-10-2024,China Ferry Terminal,Arrival,485,405,119,1009
18-10-2024,China Ferry Terminal,Departure,670,335,57,1062
19-10-2024,China Ferry Terminal,Arrival,452,654,196,1302
19-10-2024,China Ferry Terminal,Departure,793,381,47,1221
20-10-2024,China Ferry Terminal,Arrival,960,377,121,1458
20-10-2024,China Ferry Terminal,Departure,400,397,71,868
21-10-2024,China Ferry Terminal,Arrival,448,325,72,845
21-10-2024,China Ferry Terminal,Departure,494,300,75,869
22-10-2024,China Ferry Terminal,Arrival,401,324,56,781
22-10-2024,China Ferry Terminal,Departure,432,251,54,737
23-10-2024,China Ferry Terminal,Arrival,366,324,67,757
23-10-2024,China Ferry Terminal,Departure,397,321,72,790
24-10-2024,China Ferry Terminal,Arrival,433,459,81,973
24-10-2024,China Ferry Terminal,Departure,440,386,72,898
25-10-2024,China Ferry Terminal,Arrival,497,751,166,1414
25-10-2024,China Ferry Terminal,Departure,757,331,52,1140
26-10-2024,China Ferry Terminal,Arrival,341,1513,318,2172
26-10-2024,China Ferry Terminal,Departure,814,492,41,1347
27-10-2024,China Ferry Terminal,Arrival,1071,1050,262,2383
27-10-2024,China Ferry Terminal,Departure,309,1123,60,1492
28-10-2024,China Ferry Terminal,Arrival,490,1155,130,1775
28-10-2024,China Ferry Terminal,Departure,504,1154,129,1787
29-10-2024,China Ferry Terminal,Arrival,359,805,131,1295
29-10-2024,China Ferry Terminal,Departure,468,1115,181,1764
30-10-2024,China Ferry Terminal,Arrival,380,436,71,887
30-10-2024,China Ferry Terminal,Departure,396,1432,241,2069
31-10-2024,China Ferry Terminal,Arrival,397,379,92,868
31-10-2024,China Ferry Terminal,Departure,384,348,79,811
1/11/2024,China Ferry Terminal,Arrival,421,352,113,886
1/11/2024,China Ferry Terminal,Departure,805,392,72,1269
2/11/2024,China Ferry Terminal,Arrival,365,503,78,946
2/11/2024,China Ferry Terminal,Departure,813,293,50,1156
3/11/2024,China Ferry Terminal,Arrival,1037,346,68,1451
3/11/2024,China Ferry Terminal,Departure,347,369,59,775
4/11/2024,China Ferry Terminal,Arrival,504,348,98,950
4/11/2024,China Ferry Terminal,Departure,629,296,74,999
5/11/2024,China Ferry Terminal,Arrival,342,379,65,786
5/11/2024,China Ferry Terminal,Departure,438,291,52,781
6/11/2024,China Ferry Terminal,Arrival,430,359,38,827
6/11/2024,China Ferry Terminal,Departure,457,317,53,827
7/11/2024,China Ferry Terminal,Arrival,384,340,72,796
7/11/2024,China Ferry Terminal,Departure,402,289,49,740
8/11/2024,China Ferry Terminal,Arrival,459,365,89,913
8/11/2024,China Ferry Terminal,Departure,822,396,44,1262
9/11/2024,China Ferry Terminal,Arrival,402,564,88,1054
9/11/2024,China Ferry Terminal,Departure,1036,387,61,1484
10/11/2024,China Ferry Terminal,Arrival,1147,388,70,1605
10/11/2024,China Ferry Terminal,Departure,354,389,60,803
11/11/2024,China Ferry Terminal,Arrival,548,335,58,941
11/11/2024,China Ferry Terminal,Departure,579,300,70,949
12/11/2024,China Ferry Terminal,Arrival,440,359,56,855
12/11/2024,China Ferry Terminal,Departure,460,336,43,839
13-11-2024,China Ferry Terminal,Arrival,396,370,92,858
13-11-2024,China Ferry Terminal,Departure,334,317,69,720
14-11-2024,China Ferry Terminal,Arrival,212,143,33,388
14-11-2024,China Ferry Terminal,Departure,169,220,22,411
15-11-2024,China Ferry Terminal,Arrival,483,447,83,1013
15-11-2024,China Ferry Terminal,Departure,820,412,62,1294
16-11-2024,China Ferry Terminal,Arrival,361,617,86,1064
16-11-2024,China Ferry Terminal,Departure,922,396,55,1373
17-11-2024,China Ferry Terminal,Arrival,1117,458,62,1637
17-11-2024,China Ferry Terminal,Departure,375,513,40,928
18-11-2024,China Ferry Terminal,Arrival,539,399,62,1000
18-11-2024,China Ferry Terminal,Departure,441,346,57,844
19-11-2024,China Ferry Terminal,Arrival,344,368,50,762
19-11-2024,China Ferry Terminal,Departure,358,332,54,744
20-11-2024,China Ferry Terminal,Arrival,371,313,51,735
20-11-2024,China Ferry Terminal,Departure,311,280,36,627
21-11-2024,China Ferry Terminal,Arrival,356,487,69,912
21-11-2024,China Ferry Terminal,Departure,463,290,71,824
22-11-2024,China Ferry Terminal,Arrival,480,457,75,1012
22-11-2024,China Ferry Terminal,Departure,833,429,46,1308
23-11-2024,China Ferry Terminal,Arrival,428,621,73,1122
23-11-2024,China Ferry Terminal,Departure,806,418,51,1275
24-11-2024,China Ferry Terminal,Arrival,1128,374,66,1568
24-11-2024,China Ferry Terminal,Departure,500,479,72,1051
25-11-2024,China Ferry Terminal,Arrival,671,432,68,1171
25-11-2024,China Ferry Terminal,Departure,575,329,67,971
26-11-2024,China Ferry Terminal,Arrival,187,214,20,421
26-11-2024,China Ferry Terminal,Departure,265,190,30,485
27-11-2024,China Ferry Terminal,Arrival,201,200,35,436
27-11-2024,China Ferry Terminal,Departure,222,202,16,440
28-11-2024,China Ferry Terminal,Arrival,419,951,41,1411
28-11-2024,China Ferry Terminal,Departure,989,654,28,1671
29-11-2024,China Ferry Terminal,Arrival,491,1117,52,1660
29-11-2024,China Ferry Terminal,Departure,841,872,43,1756
30-11-2024,China Ferry Terminal,Arrival,621,1398,57,2076
30-11-2024,China Ferry Terminal,Departure,972,1091,33,2096
1/12/2024,China Ferry Terminal,Arrival,1445,841,52,2338
1/12/2024,China Ferry Terminal,Departure,543,1003,62,1608
2/12/2024,China Ferry Terminal,Arrival,580,508,73,1161
2/12/2024,China Ferry Terminal,Departure,624,514,57,1195
3/12/2024,China Ferry Terminal,Arrival,473,540,74,1087
3/12/2024,China Ferry Terminal,Departure,522,469,56,1047
4/12/2024,China Ferry Terminal,Arrival,493,487,76,1056
4/12/2024,China Ferry Terminal,Departure,531,425,56,1012
5/12/2024,China Ferry Terminal,Arrival,482,554,45,1081
5/12/2024,China Ferry Terminal,Departure,692,498,51,1241
6/12/2024,China Ferry Terminal,Arrival,683,609,98,1390
6/12/2024,China Ferry Terminal,Departure,1061,542,41,1644
7/12/2024,China Ferry Terminal,Arrival,621,1221,108,1950
7/12/2024,China Ferry Terminal,Departure,1218,811,70,2099
8/12/2024,China Ferry Terminal,Arrival,1457,827,65,2349
8/12/2024,China Ferry Terminal,Departure,522,1046,76,1644
9/12/2024,China Ferry Terminal,Arrival,670,605,67,1342
9/12/2024,China Ferry Terminal,Departure,682,452,55,1189
10/12/2024,China Ferry Terminal,Arrival,481,515,34,1030
10/12/2024,China Ferry Terminal,Departure,539,533,54,1126
11/12/2024,China Ferry Terminal,Arrival,499,655,57,1211
11/12/2024,China Ferry Terminal,Departure,480,533,67,1080
12/12/2024,China Ferry Terminal,Arrival,463,561,98,1122
12/12/2024,China Ferry Terminal,Departure,545,566,63,1174
13-12-2024,China Ferry Terminal,Arrival,650,743,87,1480
13-12-2024,China Ferry Terminal,Departure,998,558,53,1609
14-12-2024,China Ferry Terminal,Arrival,591,1361,69,2021
14-12-2024,China Ferry Terminal,Departure,1203,888,49,2140
15-12-2024,China Ferry Terminal,Arrival,1322,828,69,2219
15-12-2024,China Ferry Terminal,Departure,540,1102,54,1696
16-12-2024,China Ferry Terminal,Arrival,628,613,68,1309
16-12-2024,China Ferry Terminal,Departure,685,527,55,1267
17-12-2024,China Ferry Terminal,Arrival,519,760,70,1349
17-12-2024,China Ferry Terminal,Departure,506,589,47,1142
18-12-2024,China Ferry Terminal,Arrival,494,893,73,1460
18-12-2024,China Ferry Terminal,Departure,559,726,54,1339
19-12-2024,China Ferry Terminal,Arrival,514,691,78,1283
19-12-2024,China Ferry Terminal,Departure,597,748,61,1406
20-12-2024,China Ferry Terminal,Arrival,594,808,73,1475
20-12-2024,China Ferry Terminal,Departure,1132,786,68,1986
21-12-2024,China Ferry Terminal,Arrival,480,1366,78,1924
21-12-2024,China Ferry Terminal,Departure,1649,816,63,2528
22-12-2024,China Ferry Terminal,Arrival,1004,1082,43,2129
22-12-2024,China Ferry Terminal,Departure,1115,1199,104,2418
23-12-2024,China Ferry Terminal,Arrival,847,848,83,1778
23-12-2024,China Ferry Terminal,Departure,1545,806,82,2433
24-12-2024,China Ferry Terminal,Arrival,669,772,67,1508
24-12-2024,China Ferry Terminal,Departure,2187,441,47,2675
25-12-2024,China Ferry Terminal,Arrival,593,697,56,1346
25-12-2024,China Ferry Terminal,Departure,2656,697,46,3399
26-12-2024,China Ferry Terminal,Arrival,2357,547,37,2941
26-12-2024,China Ferry Terminal,Departure,1293,515,79,1887
27-12-2024,China Ferry Terminal,Arrival,1977,744,80,2801
27-12-2024,China Ferry Terminal,Departure,1218,677,78,1973
28-12-2024,China Ferry Terminal,Arrival,1366,1055,73,2494
28-12-2024,China Ferry Terminal,Departure,1320,808,66,2194
29-12-2024,China Ferry Terminal,Arrival,2154,931,89,3174
29-12-2024,China Ferry Terminal,Departure,609,912,79,1600
30-12-2024,China Ferry Terminal,Arrival,1069,865,111,2045
30-12-2024,China Ferry Terminal,Departure,682,735,51,1468
31-12-2024,China Ferry Terminal,Arrival,919,916,101,1936
31-12-2024,China Ferry Terminal,Departure,663,542,31,1236